"","district","district_name","overall_dropout","overall_enrollments","overall_rate","f_dropout","f_enrollments","f_rate","m_dropout","m_enrollments","m_rate","year"
"1",9,"AGWSR",2,230,0.87,0,112,0,2,118,1.69,2016
"2",18,"Adair-Casey",0,126,0,0,61,0,0,65,0,2016
"3",27,"Adel DeSoto Minburn",3,749,0.4,1,366,0.27,2,383,0.52,2016
"4",63,"Akron Westfield",1,246,0.41,1,108,0.93,0,138,0,2016
"5",81,"Albia",7,545,1.28,2,274,0.73,5,271,1.85,2016
"6",99,"Alburnett",4,286,1.4,1,131,0.76,3,155,1.94,2016
"7",126,"Algona",2,643,0.31,1,321,0.31,1,322,0.31,2016
"8",135,"Allamakee",9,560,1.61,2,292,0.68,7,268,2.61,2016
"9",153,"North Butler",4,255,1.57,1,112,0.89,3,143,2.1,2016
"10",171,"Alta",6,219,2.74,2,104,1.92,4,115,3.48,2016
"11",225,"Ames",20,1935,1.03,7,955,0.73,13,980,1.33,2016
"12",234,"Anamosa",6,621,0.97,3,306,0.98,3,315,0.95,2016
"13",243,"Andrew",1,35,2.86,0,16,0,1,19,5.26,2016
"14",261,"Ankeny",27,4685,0.58,10,2329,0.43,17,2356,0.72,2016
"15",279,"Aplington-Parkersburg",3,392,0.77,2,192,1.04,1,200,0.5,2016
"16",333,"North Union",2,195,1.03,1,108,0.93,1,87,1.15,2016
"17",355,"Ar-We-Va",1,93,1.08,0,44,0,1,49,2.04,2016
"18",387,"Atlantic",13,643,2.02,4,306,1.31,9,337,2.67,2016
"19",414,"Audubon",1,216,0.46,0,105,0,1,111,0.9,2016
"20",423,"Aurelia",1,103,0.97,0,55,0,1,48,2.08,2016
"21",441,"AHSTW",0,331,0,0,164,0,0,167,0,2016
"22",472,"Ballard",2,802,0.25,1,357,0.28,1,445,0.22,2016
"23",504,"Battle Creek-Ida Grove",1,275,0.36,0,136,0,1,139,0.72,2016
"24",513,"Baxter",3,190,1.58,0,84,0,3,106,2.83,2016
"25",540,"BCLUW",2,287,0.7,0,149,0,2,138,1.45,2016
"26",549,"Bedford",2,192,1.04,1,80,1.25,1,112,0.89,2016
"27",576,"Belle Plaine",6,256,2.34,3,134,2.24,3,122,2.46,2016
"28",585,"Bellevue",1,323,0.31,0,154,0,1,169,0.59,2016
"29",594,"Belmond-Klemme",0,332,0,0,166,0,0,166,0,2016
"30",609,"Benton",10,708,1.41,3,349,0.86,7,359,1.95,2016
"31",621,"Bettendorf",15,2284,0.66,4,1128,0.35,11,1156,0.95,2016
"32",657,"Eddyville-Blakesburg-",9,442,2.04,4,204,1.96,5,238,2.1,2016
"33",720,"Bondurant-Farrar",3,813,0.37,2,395,0.51,1,418,0.24,2016
"34",729,"Boone",12,963,1.25,7,474,1.48,5,489,1.02,2016
"35",747,"Boyden-Hull",4,304,1.32,2,148,1.35,2,156,1.28,2016
"36",819,"West Hancock",8,264,3.03,4,130,3.08,4,134,2.99,2016
"37",846,"Brooklyn-Guernsey-Malcom",1,244,0.41,1,137,0.73,0,107,0,2016
"38",873,"North Iowa",3,205,1.46,1,102,0.98,2,103,1.94,2016
"39",882,"Burlington",98,1697,5.77,47,843,5.58,51,854,5.97,2016
"40",914,"CAM",57,575,9.91,34,324,10.49,23,251,9.16,2016
"41",916,"CAL",3,101,2.97,2,47,4.26,1,54,1.85,2016
"42",918,"Calamus-Wheatland",3,226,1.33,2,104,1.92,1,122,0.82,2016
"43",936,"Camanche",11,458,2.4,4,214,1.87,7,244,2.87,2016
"44",977,"Cardinal",2,310,0.65,1,156,0.64,1,154,0.65,2016
"45",981,"Carlisle",11,926,1.19,2,435,0.46,9,491,1.83,2016
"46",999,"Carroll",7,719,0.97,4,341,1.17,3,378,0.79,2016
"47",1044,"Cedar Falls",19,2348,0.81,9,1160,0.78,10,1188,0.84,2016
"48",1053,"Cedar Rapids",328,7515,4.36,141,3695,3.82,187,3820,4.9,2016
"49",1062,"Center Point-Urbana",5,698,0.72,3,342,0.88,2,356,0.56,2016
"50",1071,"Centerville",18,603,2.99,5,289,1.73,13,314,4.14,2016
"51",1079,"Central Lee",7,488,1.43,3,240,1.25,4,248,1.61,2016
"52",1080,"Central",2,191,1.05,1,100,1,1,91,1.1,2016
"53",1082,"Central DeWitt",6,743,0.81,1,355,0.28,5,388,1.29,2016
"54",1089,"Central City",1,200,0.5,0,103,0,1,97,1.03,2016
"55",1093,"Central Decatur",3,296,1.01,1,141,0.71,2,155,1.29,2016
"56",1095,"Central Lyon",3,298,1.01,2,149,1.34,1,149,0.67,2016
"57",1107,"Chariton",9,597,1.51,2,291,0.69,7,306,2.29,2016
"58",1116,"Charles City",9,755,1.19,2,379,0.53,7,376,1.86,2016
"59",1134,"Charter Oak-Ute",3,125,2.4,1,65,1.54,2,60,3.33,2016
"60",1152,"Cherokee",7,440,1.59,3,220,1.36,4,220,1.82,2016
"61",1197,"Clarinda",7,421,1.66,7,215,3.26,0,206,0,2016
"62",1206,"Clarion-Goldfield-Dows",18,442,4.07,7,219,3.2,11,223,4.93,2016
"63",1211,"Clarke",12,589,2.04,2,273,0.73,10,316,3.16,2016
"64",1215,"Clarksville",1,130,0.77,1,66,1.52,0,64,0,2016
"65",1218,"Clay Central-Everly",1,139,0.72,1,71,1.41,0,68,0,2016
"66",1221,"Clear Creek Amana",8,940,0.85,4,445,0.9,4,495,0.81,2016
"67",1233,"Clear Lake",11,582,1.89,4,263,1.52,7,319,2.19,2016
"68",1278,"Clinton",43,1512,2.84,15,764,1.96,28,748,3.74,2016
"69",1332,"Colfax-Mingo",4,310,1.29,1,159,0.63,3,151,1.99,2016
"70",1337,"College",48,2415,1.99,23,1200,1.92,25,1215,2.06,2016
"71",1350,"Collins-Maxwell",4,203,1.97,3,114,2.63,1,89,1.12,2016
"72",1359,"Colo-NESCO",1,212,0.47,1,106,0.94,0,106,0,2016
"73",1368,"Columbus",3,317,0.95,3,147,2.04,0,170,0,2016
"74",1413,"Coon Rapids-Bayard",3,180,1.67,1,86,1.16,2,94,2.13,2016
"75",1431,"Corning",3,203,1.48,1,87,1.15,2,116,1.72,2016
"76",1476,"Council Bluffs",79,3801,2.08,23,1858,1.24,56,1943,2.88,2016
"77",1503,"Creston",10,658,1.52,5,324,1.54,5,334,1.5,2016
"78",1576,"Dallas Center-Grimes",14,1204,1.16,5,582,0.86,9,622,1.45,2016
"79",1602,"Danville",2,300,0.67,1,148,0.68,1,152,0.66,2016
"80",1611,"Davenport",247,6819,3.62,108,3298,3.27,139,3521,3.95,2016
"81",1619,"Davis County",10,529,1.89,5,279,1.79,5,250,2,2016
"82",1638,"Decorah Community",6,804,0.75,4,396,1.01,2,408,0.49,2016
"83",1701,"Denison",21,1024,2.05,8,489,1.64,13,535,2.43,2016
"84",1719,"Denver",0,342,0,0,153,0,0,189,0,2016
"85",1737,"Des Moines Independent",718,14032,5.12,299,6766,4.42,419,7266,5.77,2016
"86",1782,"Diagonal",0,47,0,0,25,0,0,22,0,2016
"87",1791,"Dike-New Hartford",1,400,0.25,0,200,0,1,200,0.5,2016
"88",1863,"Dubuque",85,4851,1.75,29,2355,1.23,56,2496,2.24,2016
"89",1908,"Dunkerton",1,216,0.46,1,109,0.92,0,107,0,2016
"90",1917,"Boyer Valley",4,217,1.84,2,99,2.02,2,118,1.69,2016
"91",1926,"Durant",8,325,2.46,3,155,1.94,5,170,2.94,2016
"92",1944,"Eagle Grove",13,367,3.54,4,180,2.22,9,187,4.81,2016
"93",1953,"Earlham",0,301,0,0,138,0,0,163,0,2016
"94",1963,"East Buchanan",4,265,1.51,3,126,2.38,1,139,0.72,2016
"95",1965,"Easton Valley",4,239,1.67,1,99,1.01,3,140,2.14,2016
"96",1968,"East Marshall",6,390,1.54,1,196,0.51,5,194,2.58,2016
"97",1970,"East Union",7,226,3.1,4,117,3.42,3,109,2.75,2016
"98",1972,"Eastern Allamakee",1,187,0.53,0,88,0,1,99,1.01,2016
"99",1975,"River Valley",0,195,0,0,101,0,0,94,0,2016
"100",1989,"Edgewood-Colesburg",2,246,0.81,0,119,0,2,127,1.57,2016
"101",2007,"Eldora-New Providence",4,291,1.37,2,133,1.5,2,158,1.27,2016
"102",2088,"Emmetsburg",11,386,2.85,3,175,1.71,8,211,3.79,2016
"103",2097,"English Valleys",1,203,0.49,1,110,0.91,0,93,0,2016
"104",2113,"Essex",0,111,0,0,60,0,0,51,0,2016
"105",2124,"Estherville Lincoln",4,587,0.68,3,284,1.06,1,303,0.33,2016
"106",2151,"Exira-Elk Horn-",2,195,1.03,0,90,0,2,105,1.9,2016
"107",2169,"Fairfield",10,754,1.33,2,346,0.58,8,408,1.96,2016
"108",2295,"Forest City",12,542,2.21,5,255,1.96,7,287,2.44,2016
"109",2313,"Fort Dodge",68,1651,4.12,34,787,4.32,34,864,3.94,2016
"110",2322,"Fort Madison",14,865,1.62,7,446,1.57,7,419,1.67,2016
"111",2369,"Fremont-Mills",1,207,0.48,1,103,0.97,0,104,0,2016
"112",2376,"Galva-Holstein",1,192,0.52,1,93,1.08,0,99,0,2016
"113",2403,"Garner-Hayfield-Ventura",2,477,0.42,1,230,0.43,1,247,0.4,2016
"114",2457,"George-Little Rock",7,205,3.41,1,87,1.15,6,118,5.08,2016
"115",2466,"Gilbert",5,699,0.72,1,325,0.31,4,374,1.07,2016
"116",2502,"Gladbrook-Reinbeck",2,218,0.92,0,110,0,2,108,1.85,2016
"117",2511,"Glenwood",10,918,1.09,6,425,1.41,4,493,0.81,2016
"118",2520,"Glidden-Ralston",1,149,0.67,1,75,1.33,0,74,0,2016
"119",2556,"Graettinger-Terril",1,152,0.66,0,71,0,1,81,1.23,2016
"120",2673,"Nodaway Valley",4,312,1.28,1,167,0.6,3,145,2.07,2016
"121",2682,"GMG",2,235,0.85,0,106,0,2,129,1.55,2016
"122",2709,"Grinnell-Newburg",21,753,2.79,8,353,2.27,13,400,3.25,2016
"123",2718,"Griswold",2,238,0.84,1,126,0.79,1,112,0.89,2016
"124",2727,"Grundy Center",2,304,0.66,1,132,0.76,1,172,0.58,2016
"125",2754,"Guthrie Center",4,229,1.75,1,115,0.87,3,114,2.63,2016
"126",2763,"Clayton Ridge",25,482,5.19,17,250,6.8,8,232,3.45,2016
"127",2766,"H-L-V",0,144,0,0,73,0,0,71,0,2016
"128",2772,"Hamburg",4,40,10,0,12,0,4,28,14.29,2016
"129",2781,"Hampton-Dumont",6,538,1.12,3,279,1.08,3,259,1.16,2016
"130",2826,"Harlan",9,772,1.17,3,354,0.85,6,418,1.44,2016
"131",2846,"Harris-Lake Park",0,153,0,0,66,0,0,87,0,2016
"132",2862,"Hartley-Melvin-Sanborn",3,264,1.14,1,121,0.83,2,143,1.4,2016
"133",2977,"Highland",2,311,0.64,1,139,0.72,1,172,0.58,2016
"134",2988,"Hinton",1,342,0.29,1,154,0.65,0,188,0,2016
"135",3029,"Howard-Winneshiek",8,589,1.36,4,294,1.36,4,295,1.36,2016
"136",3033,"Hubbard-Radcliffe",0,137,0,0,60,0,0,77,0,2016
"137",3042,"Hudson",1,304,0.33,0,142,0,1,162,0.62,2016
"138",3060,"Humboldt",10,720,1.39,3,372,0.81,7,348,2.01,2016
"139",3105,"Independence",3,673,0.45,2,333,0.6,1,340,0.29,2016
"140",3114,"Indianola",23,1684,1.37,12,809,1.48,11,875,1.26,2016
"141",3119,"Interstate 35",5,381,1.31,1,180,0.56,4,201,1.99,2016
"142",3141,"Iowa City",76,5931,1.28,29,2921,0.99,47,3010,1.56,2016
"143",3150,"Iowa Falls",11,635,1.73,2,330,0.61,9,305,2.95,2016
"144",3154,"Iowa Valley",1,223,0.45,0,105,0,1,118,0.85,2016
"145",3168,"IKM-Manning",3,307,0.98,3,149,2.01,0,158,0,2016
"146",3186,"Janesville Consolidated",0,153,0,0,73,0,0,80,0,2016
"147",3195,"Greene County",15,583,2.57,7,277,2.53,8,306,2.61,2016
"148",3204,"Jesup",4,371,1.08,2,160,1.25,2,211,0.95,2016
"149",3231,"Johnston",10,3130,0.32,2,1527,0.13,8,1603,0.5,2016
"150",3312,"Keokuk",27,824,3.28,10,404,2.48,17,420,4.05,2016
"151",3330,"Keota",1,126,0.79,0,49,0,1,77,1.3,2016
"152",3348,"Kingsley-Pierson",0,213,0,0,110,0,0,103,0,2016
"153",3375,"Knoxville",9,755,1.19,4,393,1.02,5,362,1.38,2016
"154",3420,"Lake Mills",3,314,0.96,0,159,0,3,155,1.94,2016
"155",3465,"Lamoni",1,157,0.64,0,82,0,1,75,1.33,2016
"156",3537,"Laurens-Marathon",2,87,2.3,0,37,0,2,50,4,2016
"157",3555,"Lawton-Bronson",0,271,0,0,135,0,0,136,0,2016
"158",3600,"Le Mars",11,977,1.13,3,448,0.67,8,529,1.51,2016
"159",3609,"Lenox",0,207,0,0,95,0,0,112,0,2016
"160",3645,"Lewis Central",17,1419,1.2,8,689,1.16,9,730,1.23,2016
"161",3691,"North Cedar",7,364,1.92,3,182,1.65,4,182,2.2,2016
"162",3715,"Linn-Mar",53,3282,1.61,17,1608,1.06,36,1674,2.15,2016
"163",3744,"Lisbon",7,284,2.46,2,144,1.39,5,140,3.57,2016
"164",3798,"Logan-Magnolia",2,303,0.66,1,149,0.67,1,154,0.65,2016
"165",3816,"Lone Tree",2,216,0.93,1,103,0.97,1,113,0.88,2016
"166",3841,"Louisa-Muscatine",9,394,2.28,4,185,2.16,5,209,2.39,2016
"167",3906,"Lynnville-Sully",1,227,0.44,0,101,0,1,126,0.79,2016
"168",3942,"Madrid",1,325,0.31,1,159,0.63,0,166,0,2016
"169",3978,"East Mills",9,215,4.19,4,108,3.7,5,107,4.67,2016
"170",4023,"Manson Northwest Webster",4,327,1.22,2,166,1.2,2,161,1.24,2016
"171",4033,"Maple Valley-Anthon Oto",5,284,1.76,2,141,1.42,3,143,2.1,2016
"172",4041,"Maquoketa",13,758,1.72,2,349,0.57,11,409,2.69,2016
"173",4043,"Maquoketa Valley",3,314,0.96,1,165,0.61,2,149,1.34,2016
"174",4068,"Marcus-Meriden-Cleghorn",5,167,2.99,2,91,2.2,3,76,3.95,2016
"175",4086,"Marion Independent",14,971,1.44,6,473,1.27,8,498,1.61,2016
"176",4104,"Marshalltown",79,2213,3.57,31,1069,2.9,48,1144,4.2,2016
"177",4122,"Martensdale-St Marys",8,277,2.89,2,118,1.69,6,159,3.77,2016
"178",4131,"Mason City",40,1610,2.48,21,801,2.62,19,809,2.35,2016
"179",4149,"MOC-Floyd Valley",9,602,1.5,4,284,1.41,5,318,1.57,2016
"180",4203,"Mediapolis",3,348,0.86,2,157,1.27,1,191,0.52,2016
"181",4212,"Melcher-Dallas",4,133,3.01,0,61,0,4,72,5.56,2016
"182",4269,"Midland",3,220,1.36,0,99,0,3,121,2.48,2016
"183",4271,"Mid-Prairie",0,588,0,0,279,0,0,309,0,2016
"184",4356,"Missouri Valley",0,381,0,0,198,0,0,183,0,2016
"185",4419,"MFL MarMac",1,310,0.32,0,160,0,1,150,0.67,2016
"186",4437,"Montezuma",7,242,2.89,2,115,1.74,5,127,3.94,2016
"187",4446,"Monticello",1,524,0.19,0,260,0,1,264,0.38,2016
"188",4491,"Moravia",1,170,0.59,1,90,1.11,0,80,0,2016
"189",4505,"Mormon Trail",0,95,0,0,47,0,0,48,0,2016
"190",4509,"Morning Sun",1,96,1.04,0,40,0,1,56,1.79,2016
"191",4518,"Moulton-Udell",0,87,0,0,43,0,0,44,0,2016
"192",4527,"Mount Ayr",0,282,0,0,138,0,0,144,0,2016
"193",4536,"Mount Pleasant",20,925,2.16,10,455,2.2,10,470,2.13,2016
"194",4554,"Mount Vernon",0,613,0,0,287,0,0,326,0,2016
"195",4572,"Murray",0,146,0,0,80,0,0,66,0,2016
"196",4581,"Muscatine",56,2274,2.46,26,1133,2.29,30,1141,2.63,2016
"197",4599,"Nashua-Plainfield",3,267,1.12,1,121,0.83,2,146,1.37,2016
"198",4617,"Nevada",11,691,1.59,4,348,1.15,7,343,2.04,2016
"199",4644,"Newell-Fonda",2,214,0.93,1,107,0.93,1,107,0.93,2016
"200",4662,"New Hampton",12,482,2.49,3,237,1.27,9,245,3.67,2016
"201",4689,"New London",2,232,0.86,1,97,1.03,1,135,0.74,2016
"202",4725,"Newton",32,1328,2.41,14,653,2.14,18,675,2.67,2016
"203",4772,"Central Springs",5,356,1.4,2,188,1.06,3,168,1.79,2016
"204",4773,"Northeast",2,418,0.48,1,204,0.49,1,214,0.47,2016
"205",4774,"North Fayette",5,333,1.5,2,170,1.18,3,163,1.84,2016
"206",4776,"North Mahaska",4,266,1.5,0,127,0,4,139,2.88,2016
"207",4777,"North Linn",3,314,0.96,1,154,0.65,2,160,1.25,2016
"208",4778,"North Kossuth",0,98,0,0,56,0,0,42,0,2016
"209",4779,"North Polk",3,668,0.45,1,331,0.3,2,337,0.59,2016
"210",4784,"North Scott",11,1422,0.77,4,686,0.58,7,736,0.95,2016
"211",4785,"North Tama County",4,228,1.75,0,95,0,4,133,3.01,2016
"212",4787,"North Winneshiek",1,25,4,0,10,0,1,15,6.67,2016
"213",4788,"Northwood-Kensett",1,241,0.41,0,125,0,1,116,0.86,2016
"214",4797,"Norwalk",13,1234,1.05,7,601,1.16,6,633,0.95,2016
"215",4860,"Odebolt-Arthur",1,148,0.68,1,73,1.37,0,75,0,2016
"216",4869,"Oelwein",7,546,1.28,4,272,1.47,3,274,1.09,2016
"217",4878,"Ogden",7,339,2.06,3,160,1.88,4,179,2.23,2016
"218",4890,"Okoboji",4,406,0.99,2,194,1.03,2,212,0.94,2016
"219",4978,"Orient-Macksburg",2,76,2.63,1,32,3.13,1,44,2.27,2016
"220",4995,"Osage",2,436,0.46,1,227,0.44,1,209,0.48,2016
"221",5013,"Oskaloosa",15,1031,1.45,5,489,1.02,10,542,1.85,2016
"222",5049,"Ottumwa",50,1879,2.66,19,933,2.04,31,946,3.28,2016
"223",5121,"Panorama",3,367,0.82,1,171,0.58,2,196,1.02,2016
"224",5139,"Paton-Churdan",0,91,0,0,40,0,0,51,0,2016
"225",5160,"PCM",3,485,0.62,2,239,0.84,1,246,0.41,2016
"226",5163,"Pekin",5,324,1.54,2,163,1.23,3,161,1.86,2016
"227",5166,"Pella",1,1013,0.1,1,499,0.2,0,514,0,2016
"228",5184,"Perry",11,873,1.26,2,407,0.49,9,466,1.93,2016
"229",5250,"Pleasant Valley",8,2102,0.38,2,1044,0.19,6,1058,0.57,2016
"230",5256,"Pleasantville",1,348,0.29,0,154,0,1,194,0.52,2016
"231",5283,"Pocahontas Area",7,356,1.97,3,177,1.69,4,179,2.23,2016
"232",5310,"Postville",4,294,1.36,1,136,0.74,3,158,1.9,2016
"233",5325,"Prairie Valley",2,354,0.56,2,175,1.14,0,179,0,2016
"234",5463,"Red Oak",10,513,1.95,4,248,1.61,6,265,2.26,2016
"235",5486,"Remsen-Union",0,81,0,0,43,0,0,38,0,2016
"236",5508,"Riceville",1,148,0.68,1,72,1.39,0,76,0,2016
"237",5510,"Riverside",3,247,1.21,0,111,0,3,136,2.21,2016
"238",5607,"Rock Valley",5,337,1.48,2,146,1.37,3,191,1.57,2016
"239",5643,"Roland-Story",3,502,0.6,2,241,0.83,1,261,0.38,2016
"240",5697,"Rudd-Rockford-Marble Rk",1,240,0.42,0,123,0,1,117,0.85,2016
"241",5724,"Ruthven-Ayrshire",2,88,2.27,1,35,2.86,1,53,1.89,2016
"242",5751,"St Ansgar",0,294,0,0,154,0,0,140,0,2016
"243",5805,"Saydel",6,623,0.96,3,285,1.05,3,338,0.89,2016
"244",5823,"Schaller-Crestland",0,102,0,0,45,0,0,57,0,2016
"245",5832,"Schleswig",0,31,0,0,19,0,0,12,0,2016
"246",5877,"Sergeant Bluff-Luton",1,738,0.14,0,356,0,1,382,0.26,2016
"247",5895,"Seymour",0,126,0,0,67,0,0,59,0,2016
"248",5922,"West Fork CSD",4,305,1.31,3,149,2.01,1,156,0.64,2016
"249",5949,"Sheldon",12,499,2.4,5,237,2.11,7,262,2.67,2016
"250",5976,"Shenandoah",4,475,0.84,1,234,0.43,3,241,1.24,2016
"251",5994,"Sibley-Ocheyedan",8,354,2.26,2,161,1.24,6,193,3.11,2016
"252",6003,"Sidney",3,253,1.19,1,109,0.92,2,144,1.39,2016
"253",6012,"Sigourney",3,265,1.13,0,113,0,3,152,1.97,2016
"254",6030,"Sioux Center",29,543,5.34,15,263,5.7,14,280,5,2016
"255",6035,"Sioux Central",10,311,3.22,5,155,3.23,5,156,3.21,2016
"256",6039,"Sioux City",155,6112,2.54,56,2938,1.91,99,3174,3.12,2016
"257",6091,"South Central Calhoun",5,398,1.26,1,189,0.53,4,209,1.91,2016
"258",6093,"Solon",0,678,0,0,315,0,0,363,0,2016
"259",6094,"Southeast Warren",5,241,2.07,3,101,2.97,2,140,1.43,2016
"260",6095,"South Hamilton",4,365,1.1,0,176,0,4,189,2.12,2016
"261",6096,"Southeast Webster Grand",0,173,0,0,74,0,0,99,0,2016
"262",6097,"South Page",1,55,1.82,1,35,2.86,0,20,0,2016
"263",6098,"South Tama County",16,686,2.33,5,334,1.5,11,352,3.13,2016
"264",6099,"South O'Brien",8,289,2.77,2,127,1.57,6,162,3.7,2016
"265",6100,"South Winneshiek",7,268,2.61,6,127,4.72,1,141,0.71,2016
"266",6101,"Southeast Polk",16,3017,0.53,7,1523,0.46,9,1494,0.6,2016
"267",6102,"Spencer",4,910,0.44,1,465,0.22,3,445,0.67,2016
"268",6120,"Spirit Lake",5,596,0.84,2,283,0.71,3,313,0.96,2016
"269",6138,"Springville",0,180,0,0,92,0,0,88,0,2016
"270",6165,"Stanton",1,114,0.88,1,49,2.04,0,65,0,2016
"271",6175,"Starmont",2,279,0.72,1,143,0.7,1,136,0.74,2016
"272",6219,"Storm Lake",18,1055,1.71,10,506,1.98,8,549,1.46,2016
"273",6264,"West Central Valley",3,368,0.82,1,168,0.6,2,200,1,2016
"274",6273,"Sumner-Fredericksburg",2,364,0.55,1,188,0.53,1,176,0.57,2016
"275",6408,"Tipton",4,454,0.88,0,234,0,4,220,1.82,2016
"276",6453,"Treynor",0,352,0,0,178,0,0,174,0,2016
"277",6460,"Tri-Center",1,312,0.32,0,134,0,1,178,0.56,2016
"278",6462,"Tri-County",0,109,0,0,57,0,0,52,0,2016
"279",6471,"Tripoli",3,213,1.41,2,103,1.94,1,110,0.91,2016
"280",6509,"Turkey Valley",0,177,0,0,79,0,0,98,0,2016
"281",6512,"Twin Cedars",5,165,3.03,3,84,3.57,2,81,2.47,2016
"282",6534,"Underwood",0,404,0,0,171,0,0,233,0,2016
"283",6536,"Union",8,575,1.39,2,262,0.76,6,313,1.92,2016
"284",6579,"Urbandale",6,1934,0.31,3,942,0.32,3,992,0.3,2016
"285",6591,"Valley",0,160,0,0,73,0,0,87,0,2016
"286",6592,"Van Buren",6,361,1.66,3,183,1.64,3,178,1.69,2016
"287",6615,"Van Meter",0,344,0,0,154,0,0,190,0,2016
"288",6651,"Villisca",1,98,1.02,1,43,2.33,0,55,0,2016
"289",6660,"Vinton-Shellsburg",20,677,2.95,4,336,1.19,16,341,4.69,2016
"290",6700,"Waco",2,196,1.02,1,96,1.04,1,100,1,2016
"291",6741,"East Sac County",5,393,1.27,2,188,1.06,3,205,1.46,2016
"292",6759,"Wapello",2,325,0.62,1,153,0.65,1,172,0.58,2016
"293",6762,"Wapsie Valley",0,300,0,0,141,0,0,159,0,2016
"294",6768,"Washington",14,822,1.7,7,374,1.87,7,448,1.56,2016
"295",6795,"Waterloo",149,4532,3.29,64,2223,2.88,85,2309,3.68,2016
"296",6822,"Waukee",4,3860,0.1,1,1932,0.05,3,1928,0.16,2016
"297",6840,"Waverly-Shell Rock",11,1017,1.08,0,480,0,11,537,2.05,2016
"298",6854,"Wayne",0,263,0,0,133,0,0,130,0,2016
"299",6867,"Webster City",10,828,1.21,1,387,0.26,9,441,2.04,2016
"300",6921,"West Bend-Mallard",3,171,1.75,1,78,1.28,2,93,2.15,2016
"301",6930,"West Branch",2,371,0.54,1,178,0.56,1,193,0.52,2016
"302",6937,"West Burlington Ind",2,424,0.47,1,203,0.49,1,221,0.45,2016
"303",6943,"West Central",1,118,0.85,1,64,1.56,0,54,0,2016
"304",6950,"West Delaware County",7,718,0.97,3,334,0.9,4,384,1.04,2016
"305",6957,"West Des Moines",57,4209,1.35,20,2060,0.97,37,2149,1.72,2016
"306",6961,"Western Dubuque",13,1676,0.78,5,824,0.61,8,852,0.94,2016
"307",6969,"West Harrison",1,161,0.62,0,84,0,1,77,1.3,2016
"308",6975,"West Liberty",8,589,1.36,4,296,1.35,4,293,1.37,2016
"309",6983,"West Lyon",0,390,0,0,187,0,0,203,0,2016
"310",6985,"West Marshall",0,438,0,0,208,0,0,230,0,2016
"311",6987,"West Monona",11,280,3.93,5,136,3.68,6,144,4.17,2016
"312",6990,"West Sioux",2,339,0.59,1,168,0.6,1,171,0.58,2016
"313",6992,"Westwood",0,257,0,0,135,0,0,122,0,2016
"314",7002,"Whiting",0,91,0,0,46,0,0,45,0,2016
"315",7029,"Williamsburg",1,541,0.18,0,260,0,1,281,0.36,2016
"316",7038,"Wilton",7,346,2.02,2,161,1.24,5,185,2.7,2016
"317",7047,"Winfield-Mt Union",1,182,0.55,1,92,1.09,0,90,0,2016
"318",7056,"Winterset",5,778,0.64,3,388,0.77,2,390,0.51,2016
"319",7092,"Woodbine",2,170,1.18,1,86,1.16,1,84,1.19,2016
"320",7098,"Woodbury Central",0,284,0,0,132,0,0,152,0,2016
"321",7110,"Woodward-Granger",4,348,1.15,1,173,0.58,3,175,1.71,2016
"322",9,"AGWSR",4,248,1.61,1,123,0.81,3,125,2.4,2017
"323",18,"Adair-Casey",0,123,0,0,54,0,0,69,0,2017
"324",27,"Adel DeSoto Minburn",2,761,0.26,1,385,0.26,1,376,0.27,2017
"325",63,"Akron Westfield",0,263,0,0,125,0,0,138,0,2017
"326",81,"Albia",2,527,0.38,1,251,0.4,1,276,0.36,2017
"327",99,"Alburnett",3,291,1.03,1,135,0.74,2,156,1.28,2017
"328",126,"Algona",18,667,2.7,8,337,2.37,10,330,3.03,2017
"329",135,"Allamakee",2,537,0.37,1,267,0.37,1,270,0.37,2017
"330",153,"North Butler",0,263,0,0,117,0,0,146,0,2017
"331",171,"Alta",8,321,2.49,6,158,3.8,2,163,1.23,2017
"332",225,"Ames",17,2042,0.83,5,1008,0.5,12,1034,1.16,2017
"333",234,"Anamosa",7,617,1.13,1,302,0.33,6,315,1.9,2017
"334",243,"Andrew",0,19,0,0,10,0,0,0,0,2017
"335",261,"Ankeny",12,4881,0.25,2,2445,0.08,10,2436,0.41,2017
"336",279,"Aplington-Parkersburg",2,382,0.52,2,178,1.12,0,204,0,2017
"337",333,"North Union",0,198,0,0,101,0,0,97,0,2017
"338",355,"Ar-We-Va",1,85,1.18,1,42,2.38,0,43,0,2017
"339",387,"Atlantic",9,647,1.39,4,302,1.32,5,345,1.45,2017
"340",414,"Audubon",3,215,1.4,0,104,0,3,111,2.7,2017
"341",441,"AHSTW",1,315,0.32,1,150,0.67,0,165,0,2017
"342",472,"Ballard",4,810,0.49,1,383,0.26,3,427,0.7,2017
"343",504,"Battle Creek-Ida Grove",5,296,1.69,2,139,1.44,3,157,1.91,2017
"344",513,"Baxter",4,191,2.09,0,90,0,4,101,3.96,2017
"345",540,"BCLUW",2,281,0.71,0,135,0,2,146,1.37,2017
"346",549,"Bedford",2,184,1.09,0,83,0,2,101,1.98,2017
"347",576,"Belle Plaine",6,261,2.3,3,131,2.29,3,130,2.31,2017
"348",585,"Bellevue",3,335,0.9,0,163,0,3,172,1.74,2017
"349",594,"Belmond-Klemme",3,326,0.92,3,151,1.99,0,175,0,2017
"350",609,"Benton",11,677,1.62,6,341,1.76,5,336,1.49,2017
"351",621,"Bettendorf",15,2252,0.67,8,1108,0.72,7,1144,0.61,2017
"352",657,"Eddyville-Blakesburg-",5,456,1.1,0,213,0,5,243,2.06,2017
"353",720,"Bondurant-Farrar",4,854,0.47,1,394,0.25,3,460,0.65,2017
"354",729,"Boone",8,953,0.84,4,468,0.85,4,485,0.82,2017
"355",747,"Boyden-Hull",4,317,1.26,0,150,0,4,167,2.4,2017
"356",819,"West Hancock",2,256,0.78,2,126,1.59,0,130,0,2017
"357",846,"Brooklyn-Guernsey-Malcom",2,250,0.8,2,143,1.4,0,107,0,2017
"358",873,"North Iowa",2,195,1.03,0,91,0,2,104,1.92,2017
"359",882,"Burlington",87,1630,5.34,41,809,5.07,46,821,5.6,2017
"360",914,"CAM",57,663,8.6,39,366,10.66,18,297,6.06,2017
"361",918,"Calamus-Wheatland",2,215,0.93,2,107,1.87,0,108,0,2017
"362",936,"Camanche",7,468,1.5,3,234,1.28,4,234,1.71,2017
"363",977,"Cardinal",3,327,0.92,1,166,0.6,2,161,1.24,2017
"364",981,"Carlisle",11,936,1.18,3,448,0.67,8,488,1.64,2017
"365",999,"Carroll",7,745,0.94,2,350,0.57,5,395,1.27,2017
"366",1044,"Cedar Falls",10,2345,0.43,1,1117,0.09,9,1228,0.73,2017
"367",1053,"Cedar Rapids",304,7487,4.06,143,3685,3.88,161,3802,4.23,2017
"368",1062,"Center Point-Urbana",4,703,0.57,2,344,0.58,2,359,0.56,2017
"369",1071,"Centerville",11,617,1.78,5,305,1.64,6,312,1.92,2017
"370",1079,"Central Lee",4,505,0.79,2,255,0.78,2,250,0.8,2017
"371",1080,"Central",0,202,0,0,113,0,0,89,0,2017
"372",1082,"Central DeWitt",6,752,0.8,1,347,0.29,5,405,1.23,2017
"373",1089,"Central City",0,207,0,0,105,0,0,102,0,2017
"374",1093,"Central Decatur",4,298,1.34,0,149,0,4,149,2.68,2017
"375",1095,"Central Lyon",4,311,1.29,2,155,1.29,2,156,1.28,2017
"376",1107,"Chariton",2,557,0.36,1,267,0.37,1,290,0.34,2017
"377",1116,"Charles City",20,761,2.63,12,375,3.2,8,386,2.07,2017
"378",1134,"Charter Oak-Ute",0,30,0,0,18,0,0,12,0,2017
"379",1152,"Cherokee",2,454,0.44,2,233,0.86,0,221,0,2017
"380",1197,"Clarinda",6,613,0.98,5,282,1.77,1,331,0.3,2017
"381",1206,"Clarion-Goldfield-Dows",14,428,3.27,7,215,3.26,7,213,3.29,2017
"382",1211,"Clarke",13,623,2.09,3,280,1.07,10,343,2.92,2017
"383",1215,"Clarksville",0,122,0,0,60,0,0,62,0,2017
"384",1218,"Clay Central-Everly",1,123,0.81,0,66,0,1,57,1.75,2017
"385",1221,"Clear Creek Amana",15,963,1.56,2,451,0.44,13,512,2.54,2017
"386",1233,"Clear Lake",10,604,1.66,2,264,0.76,8,340,2.35,2017
"387",1278,"Clinton",51,1451,3.51,26,709,3.67,25,742,3.37,2017
"388",1332,"Colfax-Mingo",1,330,0.3,1,169,0.59,0,161,0,2017
"389",1337,"College",34,2493,1.36,12,1231,0.97,22,1262,1.74,2017
"390",1350,"Collins-Maxwell",1,182,0.55,0,88,0,1,94,1.06,2017
"391",1359,"Colo-NESCO",1,211,0.47,0,106,0,1,105,0.95,2017
"392",1368,"Columbus",7,306,2.29,2,129,1.55,5,177,2.82,2017
"393",1413,"Coon Rapids-Bayard",2,185,1.08,0,94,0,2,91,2.2,2017
"394",1431,"Corning",6,186,3.23,3,85,3.53,3,101,2.97,2017
"395",1476,"Council Bluffs",76,3870,1.96,33,1885,1.75,43,1985,2.17,2017
"396",1503,"Creston",16,688,2.33,8,352,2.27,8,336,2.38,2017
"397",1576,"Dallas Center-Grimes",10,1233,0.81,7,620,1.13,3,613,0.49,2017
"398",1602,"Danville",7,304,2.3,1,142,0.7,6,162,3.7,2017
"399",1611,"Davenport",264,6798,3.88,110,3349,3.28,154,3449,4.47,2017
"400",1619,"Davis County",8,526,1.52,3,282,1.06,5,244,2.05,2017
"401",1638,"Decorah Community",2,853,0.23,1,416,0.24,1,437,0.23,2017
"402",1701,"Denison",26,1122,2.32,11,546,2.01,15,576,2.6,2017
"403",1719,"Denver",0,344,0,0,151,0,0,193,0,2017
"404",1737,"Des Moines Independent",612,14244,4.3,249,6954,3.58,363,7290,4.98,2017
"405",1782,"Diagonal",0,49,0,0,25,0,0,24,0,2017
"406",1791,"Dike-New Hartford",1,393,0.25,0,194,0,1,199,0.5,2017
"407",1863,"Dubuque",99,4850,2.04,40,2352,1.7,59,2498,2.36,2017
"408",1908,"Dunkerton",3,215,1.4,1,108,0.93,2,107,1.87,2017
"409",1917,"Boyer Valley",2,204,0.98,1,87,1.15,1,117,0.85,2017
"410",1926,"Durant",7,328,2.13,2,156,1.28,5,172,2.91,2017
"411",1944,"Eagle Grove",8,358,2.23,3,169,1.78,5,189,2.65,2017
"412",1953,"Earlham",1,286,0.35,1,129,0.78,0,157,0,2017
"413",1963,"East Buchanan",1,270,0.37,1,134,0.75,0,136,0,2017
"414",1965,"Easton Valley",3,231,1.3,1,98,1.02,2,133,1.5,2017
"415",1968,"East Marshall",8,366,2.19,2,178,1.12,6,188,3.19,2017
"416",1970,"East Union",7,219,3.2,1,107,0.93,6,112,5.36,2017
"417",1972,"Eastern Allamakee",2,177,1.13,2,83,2.41,0,94,0,2017
"418",1975,"River Valley",2,196,1.02,2,100,2,0,96,0,2017
"419",1989,"Edgewood-Colesburg",2,239,0.84,0,115,0,2,124,1.61,2017
"420",2007,"Eldora-New Providence",8,281,2.85,2,124,1.61,6,157,3.82,2017
"421",2088,"Emmetsburg",6,385,1.56,1,182,0.55,5,203,2.46,2017
"422",2097,"English Valleys",4,198,2.02,1,101,0.99,3,97,3.09,2017
"423",2113,"Essex",0,100,0,0,51,0,0,49,0,2017
"424",2124,"Estherville Lincoln",7,602,1.16,3,301,1,4,301,1.33,2017
"425",2151,"Exira-Elk Horn-",1,169,0.59,1,83,1.2,0,86,0,2017
"426",2169,"Fairfield",24,772,3.11,11,366,3.01,13,406,3.2,2017
"427",2295,"Forest City",10,542,1.85,4,262,1.53,6,280,2.14,2017
"428",2313,"Fort Dodge",78,1708,4.57,23,798,2.88,55,910,6.04,2017
"429",2322,"Fort Madison",23,845,2.72,9,437,2.06,14,408,3.43,2017
"430",2369,"Fremont-Mills",2,196,1.02,2,92,2.17,0,104,0,2017
"431",2376,"Galva-Holstein",1,194,0.52,0,94,0,1,100,1,2017
"432",2403,"Garner-Hayfield-Ventura",3,473,0.63,3,222,1.35,0,251,0,2017
"433",2457,"George-Little Rock",0,203,0,0,86,0,0,117,0,2017
"434",2466,"Gilbert",1,721,0.14,0,341,0,1,380,0.26,2017
"435",2502,"Gladbrook-Reinbeck",2,220,0.91,1,109,0.92,1,111,0.9,2017
"436",2511,"Glenwood",8,954,0.84,3,439,0.68,5,515,0.97,2017
"437",2520,"Glidden-Ralston",2,135,1.48,0,64,0,2,71,2.82,2017
"438",2556,"Graettinger-Terril",2,147,1.36,1,73,1.37,1,74,1.35,2017
"439",2673,"Nodaway Valley",3,284,1.06,0,153,0,3,131,2.29,2017
"440",2682,"GMG",2,231,0.87,0,107,0,2,124,1.61,2017
"441",2709,"Grinnell-Newburg",5,754,0.66,2,359,0.56,3,395,0.76,2017
"442",2718,"Griswold",1,222,0.45,0,113,0,1,109,0.92,2017
"443",2727,"Grundy Center",0,300,0,0,137,0,0,163,0,2017
"444",2754,"Guthrie Center",2,233,0.86,1,119,0.84,1,114,0.88,2017
"445",2763,"Clayton Ridge",25,471,5.31,10,235,4.26,15,236,6.36,2017
"446",2766,"H-L-V",0,143,0,0,74,0,0,69,0,2017
"447",2772,"Hamburg",0,31,0,0,17,0,0,14,0,2017
"448",2781,"Hampton-Dumont",3,648,0.46,1,319,0.31,2,329,0.61,2017
"449",2826,"Harlan",5,763,0.66,2,356,0.56,3,407,0.74,2017
"450",2846,"Harris-Lake Park",1,153,0.65,0,67,0,1,86,1.16,2017
"451",2862,"Hartley-Melvin-Sanborn",4,271,1.48,3,119,2.52,1,152,0.66,2017
"452",2977,"Highland",4,286,1.4,3,131,2.29,1,155,0.65,2017
"453",2988,"Hinton",1,348,0.29,0,158,0,1,190,0.53,2017
"454",3029,"Howard-Winneshiek",4,583,0.69,2,282,0.71,2,301,0.66,2017
"455",3033,"Hubbard-Radcliffe",0,134,0,0,66,0,0,68,0,2017
"456",3042,"Hudson",1,316,0.32,0,147,0,1,169,0.59,2017
"457",3060,"Humboldt",11,724,1.52,3,369,0.81,8,355,2.25,2017
"458",3105,"Independence",6,704,0.85,1,356,0.28,5,348,1.44,2017
"459",3114,"Indianola",10,1661,0.6,1,809,0.12,9,852,1.06,2017
"460",3119,"Interstate 35",2,374,0.53,1,171,0.58,1,203,0.49,2017
"461",3141,"Iowa City",111,6122,1.81,45,3017,1.49,66,3105,2.13,2017
"462",3150,"Iowa Falls",14,628,2.23,4,338,1.18,10,290,3.45,2017
"463",3154,"Iowa Valley",0,242,0,0,112,0,0,130,0,2017
"464",3168,"IKM-Manning",4,299,1.34,2,149,1.34,2,150,1.33,2017
"465",3186,"Janesville Consolidated",0,171,0,0,82,0,0,89,0,2017
"466",3195,"Greene County",14,569,2.46,6,267,2.25,8,302,2.65,2017
"467",3204,"Jesup",3,388,0.77,1,177,0.56,2,211,0.95,2017
"468",3231,"Johnston",22,3316,0.66,11,1595,0.69,11,1721,0.64,2017
"469",3312,"Keokuk",32,818,3.91,7,407,1.72,25,411,6.08,2017
"470",3330,"Keota",0,126,0,0,51,0,0,75,0,2017
"471",3348,"Kingsley-Pierson",0,221,0,0,122,0,0,99,0,2017
"472",3375,"Knoxville",16,764,2.09,7,388,1.8,9,376,2.39,2017
"473",3420,"Lake Mills",2,318,0.63,1,164,0.61,1,154,0.65,2017
"474",3465,"Lamoni",3,150,2,0,80,0,3,70,4.29,2017
"475",3537,"Laurens-Marathon",0,30,0,0,11,0,0,19,0,2017
"476",3555,"Lawton-Bronson",0,272,0,0,131,0,0,141,0,2017
"477",3600,"Le Mars",10,988,1.01,8,472,1.69,2,516,0.39,2017
"478",3609,"Lenox",0,217,0,0,102,0,0,115,0,2017
"479",3645,"Lewis Central",10,1375,0.73,3,679,0.44,7,696,1.01,2017
"480",3691,"North Cedar",9,356,2.53,2,174,1.15,7,182,3.85,2017
"481",3715,"Linn-Mar",36,3333,1.08,12,1584,0.76,24,1749,1.37,2017
"482",3744,"Lisbon",4,274,1.46,0,133,0,4,141,2.84,2017
"483",3798,"Logan-Magnolia",0,304,0,0,148,0,0,156,0,2017
"484",3816,"Lone Tree",5,219,2.28,1,105,0.95,4,114,3.51,2017
"485",3841,"Louisa-Muscatine",10,415,2.41,3,204,1.47,7,211,3.32,2017
"486",3906,"Lynnville-Sully",1,243,0.41,1,106,0.94,0,137,0,2017
"487",3942,"Madrid",0,311,0,0,152,0,0,159,0,2017
"488",3978,"East Mills",1,201,0.5,0,102,0,1,99,1.01,2017
"489",4023,"Manson Northwest Webster",3,330,0.91,0,162,0,3,168,1.79,2017
"490",4033,"Maple Valley-Anthon Oto",7,335,2.09,2,157,1.27,5,178,2.81,2017
"491",4041,"Maquoketa",9,726,1.24,2,352,0.57,7,374,1.87,2017
"492",4043,"Maquoketa Valley",2,295,0.68,1,160,0.63,1,135,0.74,2017
"493",4068,"Marcus-Meriden-Cleghorn",1,165,0.61,0,88,0,1,77,1.3,2017
"494",4086,"Marion Independent",8,1008,0.79,2,496,0.4,6,512,1.17,2017
"495",4104,"Marshalltown",64,2253,2.84,26,1089,2.39,38,1164,3.26,2017
"496",4122,"Martensdale-St Marys",3,264,1.14,2,108,1.85,1,156,0.64,2017
"497",4131,"Mason City",34,1646,2.07,9,793,1.13,25,853,2.93,2017
"498",4149,"MOC-Floyd Valley",4,635,0.63,3,295,1.02,1,340,0.29,2017
"499",4203,"Mediapolis",3,364,0.82,3,160,1.88,0,204,0,2017
"500",4212,"Melcher-Dallas",2,134,1.49,1,63,1.59,1,71,1.41,2017
"501",4269,"Midland",5,222,2.25,4,107,3.74,1,115,0.87,2017
"502",4271,"Mid-Prairie",9,579,1.55,1,268,0.37,8,311,2.57,2017
"503",4356,"Missouri Valley",4,374,1.07,0,185,0,4,189,2.12,2017
"504",4419,"MFL MarMac",2,312,0.64,0,161,0,2,151,1.32,2017
"505",4437,"Montezuma",4,220,1.82,1,115,0.87,3,105,2.86,2017
"506",4446,"Monticello",1,574,0.17,1,287,0.35,0,287,0,2017
"507",4491,"Moravia",1,175,0.57,1,89,1.12,0,86,0,2017
"508",4505,"Mormon Trail",4,99,4.04,1,49,2.04,3,50,6,2017
"509",4518,"Moulton-Udell",0,76,0,0,40,0,0,36,0,2017
"510",4527,"Mount Ayr",4,314,1.27,1,149,0.67,3,165,1.82,2017
"511",4536,"Mount Pleasant",19,933,2.04,5,462,1.08,14,471,2.97,2017
"512",4554,"Mount Vernon",2,620,0.32,0,290,0,2,330,0.61,2017
"513",4572,"Murray",3,145,2.07,0,74,0,3,71,4.23,2017
"514",4581,"Muscatine",83,2227,3.73,28,1103,2.54,55,1124,4.89,2017
"515",4599,"Nashua-Plainfield",6,266,2.26,0,121,0,6,145,4.14,2017
"516",4617,"Nevada",3,679,0.44,0,331,0,3,348,0.86,2017
"517",4644,"Newell-Fonda",2,230,0.87,0,113,0,2,117,1.71,2017
"518",4662,"New Hampton",12,489,2.45,4,253,1.58,8,236,3.39,2017
"519",4689,"New London",2,257,0.78,2,105,1.9,0,152,0,2017
"520",4725,"Newton",22,1379,1.6,14,696,2.01,8,683,1.17,2017
"521",4772,"Central Springs",0,337,0,0,177,0,0,160,0,2017
"522",4773,"Northeast",0,390,0,0,180,0,0,210,0,2017
"523",4774,"North Fayette",3,501,0.6,0,251,0,3,250,1.2,2017
"524",4776,"North Mahaska",2,233,0.86,2,117,1.71,0,116,0,2017
"525",4777,"North Linn",5,303,1.65,2,146,1.37,3,157,1.91,2017
"526",4778,"North Kossuth",1,94,1.06,0,51,0,1,43,2.33,2017
"527",4779,"North Polk",4,724,0.55,1,355,0.28,3,369,0.81,2017
"528",4784,"North Scott",8,1453,0.55,4,716,0.56,4,737,0.54,2017
"529",4785,"North Tama County",1,214,0.47,0,99,0,1,115,0.87,2017
"530",4788,"Northwood-Kensett",0,236,0,0,110,0,0,126,0,2017
"531",4797,"Norwalk",4,1310,0.31,2,631,0.32,2,679,0.29,2017
"532",4860,"Odebolt-Arthur",0,143,0,0,65,0,0,78,0,2017
"533",4869,"Oelwein",17,538,3.16,8,269,2.97,9,269,3.35,2017
"534",4878,"Ogden",6,320,1.88,1,138,0.72,5,182,2.75,2017
"535",4890,"Okoboji",7,420,1.67,5,213,2.35,2,207,0.97,2017
"536",4978,"Orient-Macksburg",3,70,4.29,2,29,6.9,1,41,2.44,2017
"537",4995,"Osage",2,425,0.47,0,213,0,2,212,0.94,2017
"538",5013,"Oskaloosa",15,1022,1.47,4,457,0.88,11,565,1.95,2017
"539",5049,"Ottumwa",65,1934,3.36,28,971,2.88,37,963,3.84,2017
"540",5121,"Panorama",1,368,0.27,0,183,0,1,185,0.54,2017
"541",5139,"Paton-Churdan",0,92,0,0,44,0,0,48,0,2017
"542",5160,"PCM",2,477,0.42,0,226,0,2,251,0.8,2017
"543",5163,"Pekin",2,317,0.63,2,160,1.25,0,157,0,2017
"544",5166,"Pella",1,1018,0.1,0,478,0,1,540,0.19,2017
"545",5184,"Perry",20,826,2.42,7,398,1.76,13,428,3.04,2017
"546",5250,"Pleasant Valley",18,2187,0.82,6,1075,0.56,12,1112,1.08,2017
"547",5256,"Pleasantville",1,350,0.29,1,155,0.65,0,195,0,2017
"548",5283,"Pocahontas Area",14,397,3.53,4,184,2.17,10,213,4.69,2017
"549",5310,"Postville",10,305,3.28,4,147,2.72,6,158,3.8,2017
"550",5325,"Prairie Valley",5,326,1.53,3,165,1.82,2,161,1.24,2017
"551",5463,"Red Oak",10,487,2.05,3,236,1.27,7,251,2.79,2017
"552",5486,"Remsen-Union",0,95,0,0,47,0,0,48,0,2017
"553",5508,"Riceville",1,153,0.65,0,77,0,1,76,1.32,2017
"554",5510,"Riverside",1,244,0.41,0,105,0,1,139,0.72,2017
"555",5607,"Rock Valley",2,353,0.57,1,154,0.65,1,199,0.5,2017
"556",5643,"Roland-Story",2,487,0.41,1,241,0.41,1,246,0.41,2017
"557",5697,"Rudd-Rockford-Marble Rk",1,219,0.46,0,101,0,1,118,0.85,2017
"558",5724,"Ruthven-Ayrshire",1,84,1.19,1,38,2.63,0,46,0,2017
"559",5751,"St Ansgar",1,291,0.34,1,160,0.63,0,131,0,2017
"560",5805,"Saydel",13,627,2.07,4,290,1.38,9,337,2.67,2017
"561",5823,"Schaller-Crestland",0,113,0,0,53,0,0,60,0,2017
"562",5832,"Schleswig",0,29,0,0,14,0,0,15,0,2017
"563",5877,"Sergeant Bluff-Luton",2,754,0.27,1,366,0.27,1,388,0.26,2017
"564",5895,"Seymour",1,118,0.85,0,62,0,1,56,1.79,2017
"565",5922,"West Fork CSD",3,294,1.02,0,149,0,3,145,2.07,2017
"566",5949,"Sheldon",9,504,1.79,4,235,1.7,5,269,1.86,2017
"567",5976,"Shenandoah",2,464,0.43,2,224,0.89,0,240,0,2017
"568",5994,"Sibley-Ocheyedan",6,372,1.61,0,171,0,6,201,2.99,2017
"569",6003,"Sidney",3,258,1.16,1,118,0.85,2,140,1.43,2017
"570",6012,"Sigourney",1,272,0.37,0,121,0,1,151,0.66,2017
"571",6030,"Sioux Center",27,571,4.73,10,271,3.69,17,300,5.67,2017
"572",6035,"Sioux Central",1,362,0.28,0,165,0,1,197,0.51,2017
"573",6039,"Sioux City",135,6237,2.16,43,2999,1.43,92,3238,2.84,2017
"574",6091,"South Central Calhoun",4,390,1.03,3,186,1.61,1,204,0.49,2017
"575",6093,"Solon",1,677,0.15,0,320,0,1,357,0.28,2017
"576",6094,"Southeast Warren",2,233,0.86,1,101,0.99,1,132,0.76,2017
"577",6095,"South Hamilton",0,352,0,0,177,0,0,175,0,2017
"578",6096,"Southeast Webster Grand",0,168,0,0,65,0,0,103,0,2017
"579",6097,"South Page",0,62,0,0,36,0,0,26,0,2017
"580",6098,"South Tama County",15,697,2.15,3,339,0.88,12,358,3.35,2017
"581",6099,"South O'Brien",5,285,1.75,4,132,3.03,1,153,0.65,2017
"582",6100,"South Winneshiek",1,270,0.37,0,126,0,1,144,0.69,2017
"583",6101,"Southeast Polk",21,3129,0.67,9,1564,0.58,12,1565,0.77,2017
"584",6102,"Spencer",12,948,1.27,5,490,1.02,7,458,1.53,2017
"585",6120,"Spirit Lake",7,600,1.17,3,292,1.03,4,308,1.3,2017
"586",6138,"Springville",0,187,0,0,95,0,0,92,0,2017
"587",6165,"Stanton",0,102,0,0,41,0,0,61,0,2017
"588",6175,"Starmont",3,269,1.12,2,134,1.49,1,135,0.74,2017
"589",6219,"Storm Lake",18,1167,1.54,10,536,1.87,8,631,1.27,2017
"590",6264,"West Central Valley",4,356,1.12,1,168,0.6,3,188,1.6,2017
"591",6273,"Sumner-Fredericksburg",8,353,2.27,4,192,2.08,4,161,2.48,2017
"592",6408,"Tipton",5,452,1.11,3,226,1.33,2,226,0.88,2017
"593",6453,"Treynor",1,365,0.27,1,176,0.57,0,189,0,2017
"594",6460,"Tri-Center",0,307,0,0,136,0,0,171,0,2017
"595",6462,"Tri-County",0,112,0,0,55,0,0,57,0,2017
"596",6471,"Tripoli",2,213,0.94,1,100,1,1,113,0.88,2017
"597",6509,"Turkey Valley",1,183,0.55,0,82,0,1,101,0.99,2017
"598",6512,"Twin Cedars",3,151,1.99,0,76,0,3,75,4,2017
"599",6534,"Underwood",1,402,0.25,1,175,0.57,0,227,0,2017
"600",6536,"Union",7,512,1.37,2,228,0.88,5,284,1.76,2017
"601",6579,"Urbandale",8,1932,0.41,2,929,0.22,6,1003,0.6,2017
"602",6592,"Van Buren",3,376,0.8,0,176,0,3,200,1.5,2017
"603",6615,"Van Meter",4,374,1.07,3,160,1.88,1,214,0.47,2017
"604",6651,"Villisca",0,95,0,0,45,0,0,50,0,2017
"605",6660,"Vinton-Shellsburg",12,693,1.73,4,365,1.1,8,328,2.44,2017
"606",6700,"Waco",3,207,1.45,1,97,1.03,2,110,1.82,2017
"607",6741,"East Sac County",2,387,0.52,1,197,0.51,1,190,0.53,2017
"608",6759,"Wapello",1,324,0.31,0,152,0,1,172,0.58,2017
"609",6762,"Wapsie Valley",2,301,0.66,0,145,0,2,156,1.28,2017
"610",6768,"Washington",15,829,1.81,5,380,1.32,10,449,2.23,2017
"611",6795,"Waterloo",144,4559,3.16,72,2279,3.16,72,2280,3.16,2017
"612",6822,"Waukee",3,4180,0.07,0,2082,0,3,2098,0.14,2017
"613",6840,"Waverly-Shell Rock",12,1091,1.1,4,523,0.76,8,568,1.41,2017
"614",6854,"Wayne",3,271,1.11,1,140,0.71,2,131,1.53,2017
"615",6867,"Webster City",10,808,1.24,3,382,0.79,7,426,1.64,2017
"616",6921,"West Bend-Mallard",1,158,0.63,1,67,1.49,0,91,0,2017
"617",6930,"West Branch",4,378,1.06,1,180,0.56,3,198,1.52,2017
"618",6937,"West Burlington Ind",5,431,1.16,3,221,1.36,2,210,0.95,2017
"619",6943,"West Central",0,120,0,0,61,0,0,59,0,2017
"620",6950,"West Delaware County",7,721,0.97,1,333,0.3,6,388,1.55,2017
"621",6957,"West Des Moines",49,4236,1.16,19,2064,0.92,30,2172,1.38,2017
"622",6961,"Western Dubuque",8,1648,0.49,4,813,0.49,4,835,0.48,2017
"623",6969,"West Harrison",3,163,1.84,1,82,1.22,2,81,2.47,2017
"624",6975,"West Liberty",12,589,2.04,2,286,0.7,10,303,3.3,2017
"625",6983,"West Lyon",1,404,0.25,0,188,0,1,216,0.46,2017
"626",6985,"West Marshall",3,469,0.64,0,225,0,3,244,1.23,2017
"627",6987,"West Monona",3,279,1.08,1,137,0.73,2,142,1.41,2017
"628",6990,"West Sioux",7,355,1.97,2,173,1.16,5,182,2.75,2017
"629",6992,"Westwood",0,254,0,0,127,0,0,127,0,2017
"630",7002,"Whiting",0,101,0,0,46,0,0,55,0,2017
"631",7029,"Williamsburg",4,546,0.73,2,262,0.76,2,284,0.7,2017
"632",7038,"Wilton",3,357,0.84,2,158,1.27,1,199,0.5,2017
"633",7047,"Winfield-Mt Union",3,225,1.33,2,109,1.83,1,116,0.86,2017
"634",7056,"Winterset",4,794,0.5,3,394,0.76,1,400,0.25,2017
"635",7092,"Woodbine",2,176,1.14,0,84,0,2,92,2.17,2017
"636",7098,"Woodbury Central",1,277,0.36,0,133,0,1,144,0.69,2017
"637",7110,"Woodward-Granger",2,580,0.34,1,195,0.51,1,385,0.26,2017
"638",9,"AGWSR",2,250,0.8,0,125,0,2,125,1.6,2018
"639",18,"Adair-Casey",0,110,0,0,47,0,0,63,0,2018
"640",27,"Adel DeSoto Minburn",3,798,0.38,0,407,0,3,391,0.77,2018
"641",63,"Akron Westfield",0,272,0,0,131,0,0,141,0,2018
"642",81,"Albia",5,549,0.91,2,263,0.76,3,286,1.05,2018
"643",99,"Alburnett",2,299,0.67,2,140,1.43,0,159,0,2018
"644",126,"Algona",14,668,2.1,6,330,1.82,8,338,2.37,2018
"645",135,"Allamakee",8,544,1.47,3,265,1.13,5,279,1.79,2018
"646",153,"North Butler",2,260,0.77,0,115,0,2,145,1.38,2018
"647",171,"Alta-Aurelia",3,320,0.94,2,161,1.24,1,159,0.63,2018
"648",225,"Ames",19,2048,0.93,8,1005,0.8,11,1043,1.05,2018
"649",234,"Anamosa",8,621,1.29,4,294,1.36,4,327,1.22,2018
"650",243,"Andrew",0,18,0,0,0,0,0,11,0,2018
"651",261,"Ankeny",27,5128,0.53,7,2527,0.28,20,2601,0.77,2018
"652",279,"Aplington-Parkersburg",2,356,0.56,2,180,1.11,0,176,0,2018
"653",333,"North Union",0,202,0,0,105,0,0,97,0,2018
"654",355,"Ar-We-Va",0,87,0,0,42,0,0,45,0,2018
"655",387,"Atlantic",6,613,0.98,1,287,0.35,5,326,1.53,2018
"656",414,"Audubon",2,216,0.93,2,111,1.8,0,105,0,2018
"657",441,"AHSTW",2,323,0.62,1,172,0.58,1,151,0.66,2018
"658",472,"Ballard",5,761,0.66,3,369,0.81,2,392,0.51,2018
"659",513,"Baxter",2,187,1.07,1,93,1.08,1,94,1.06,2018
"660",540,"BCLUW",2,274,0.73,1,127,0.79,1,147,0.68,2018
"661",549,"Bedford",0,197,0,0,93,0,0,104,0,2018
"662",576,"Belle Plaine",3,244,1.23,2,127,1.57,1,117,0.85,2018
"663",585,"Bellevue",2,351,0.57,1,170,0.59,1,181,0.55,2018
"664",594,"Belmond-Klemme",7,333,2.1,4,151,2.65,3,182,1.65,2018
"665",609,"Benton",7,693,1.01,2,343,0.58,5,350,1.43,2018
"666",621,"Bettendorf",11,2298,0.48,6,1136,0.53,5,1162,0.43,2018
"667",657,"Eddyville-Blakesburg-",12,465,2.58,4,217,1.84,8,248,3.23,2018
"668",720,"Bondurant-Farrar",5,911,0.55,3,408,0.74,2,503,0.4,2018
"669",729,"Boone",11,955,1.15,5,441,1.13,6,514,1.17,2018
"670",747,"Boyden-Hull",5,329,1.52,2,160,1.25,3,169,1.78,2018
"671",819,"West Hancock",5,266,1.88,3,129,2.33,2,137,1.46,2018
"672",846,"Brooklyn-Guernsey-Malcom",1,242,0.41,0,131,0,1,111,0.9,2018
"673",873,"North Iowa",1,188,0.53,0,86,0,1,102,0.98,2018
"674",882,"Burlington",102,1567,6.51,40,772,5.18,62,795,7.8,2018
"675",914,"CAM",62,706,8.78,30,393,7.63,32,313,10.22,2018
"676",918,"Calamus-Wheatland",1,219,0.46,0,114,0,1,105,0.95,2018
"677",936,"Camanche",4,452,0.88,2,236,0.85,2,216,0.93,2018
"678",977,"Cardinal",3,362,0.83,1,186,0.54,2,176,1.14,2018
"679",981,"Carlisle",1,968,0.1,0,485,0,1,483,0.21,2018
"680",999,"Carroll",9,780,1.15,3,366,0.82,6,414,1.45,2018
"681",1044,"Cedar Falls",19,2409,0.79,9,1141,0.79,10,1268,0.79,2018
"682",1053,"Cedar Rapids",253,7329,3.45,107,3588,2.98,146,3741,3.9,2018
"683",1062,"Center Point-Urbana",5,714,0.7,3,340,0.88,2,374,0.53,2018
"684",1071,"Centerville",11,605,1.82,4,290,1.38,7,315,2.22,2018
"685",1079,"Central Lee",5,479,1.04,1,240,0.42,4,239,1.67,2018
"686",1080,"Central",2,205,0.98,1,116,0.86,1,89,1.12,2018
"687",1082,"Central DeWitt",10,741,1.35,4,344,1.16,6,397,1.51,2018
"688",1089,"Central City",2,202,0.99,1,108,0.93,1,94,1.06,2018
"689",1093,"Central Decatur",1,304,0.33,1,161,0.62,0,143,0,2018
"690",1095,"Central Lyon",1,336,0.3,1,166,0.6,0,170,0,2018
"691",1107,"Chariton",4,558,0.72,0,262,0,4,296,1.35,2018
"692",1116,"Charles City",9,796,1.13,6,388,1.55,3,408,0.74,2018
"693",1134,"Charter Oak-Ute",0,30,0,0,18,0,0,12,0,2018
"694",1152,"Cherokee",3,468,0.64,1,243,0.41,2,225,0.89,2018
"695",1197,"Clarinda",4,594,0.67,2,269,0.74,2,325,0.62,2018
"696",1206,"Clarion-Goldfield-Dows",5,425,1.18,0,219,0,5,206,2.43,2018
"697",1211,"Clarke",16,613,2.61,6,274,2.19,10,339,2.95,2018
"698",1215,"Clarksville",0,130,0,0,65,0,0,65,0,2018
"699",1218,"Clay Central-Everly",0,110,0,0,57,0,0,53,0,2018
"700",1221,"Clear Creek Amana",9,1000,0.9,4,483,0.83,5,517,0.97,2018
"701",1233,"Clear Lake",5,586,0.85,2,259,0.77,3,327,0.92,2018
"702",1278,"Clinton",45,1456,3.09,14,701,2,31,755,4.11,2018
"703",1332,"Colfax-Mingo",4,343,1.17,2,174,1.15,2,169,1.18,2018
"704",1337,"College",44,2550,1.73,12,1263,0.95,32,1287,2.49,2018
"705",1350,"Collins-Maxwell",2,191,1.05,1,93,1.08,1,98,1.02,2018
"706",1359,"Colo-NESCO",3,192,1.56,1,103,0.97,2,89,2.25,2018
"707",1368,"Columbus",10,295,3.39,3,137,2.19,7,158,4.43,2018
"708",1413,"Coon Rapids-Bayard",2,169,1.18,1,82,1.22,1,87,1.15,2018
"709",1431,"Corning",6,180,3.33,3,93,3.23,3,87,3.45,2018
"710",1476,"Council Bluffs",80,3895,2.05,34,1876,1.81,46,2019,2.28,2018
"711",1503,"Creston",7,687,1.02,1,336,0.3,6,351,1.71,2018
"712",1576,"Dallas Center-Grimes",2,1281,0.16,0,652,0,2,629,0.32,2018
"713",1602,"Danville",4,321,1.25,2,159,1.26,2,162,1.23,2018
"714",1611,"Davenport",314,6747,4.65,116,3350,3.46,198,3397,5.83,2018
"715",1619,"Davis County",3,555,0.54,2,278,0.72,1,277,0.36,2018
"716",1638,"Decorah Community",2,858,0.23,1,421,0.24,1,437,0.23,2018
"717",1701,"Denison",17,1136,1.5,8,565,1.42,9,571,1.58,2018
"718",1719,"Denver",3,358,0.84,1,160,0.63,2,198,1.01,2018
"719",1737,"Des Moines Independent",553,14391,3.84,222,7014,3.17,331,7377,4.49,2018
"720",1782,"Diagonal",0,53,0,0,24,0,0,29,0,2018
"721",1791,"Dike-New Hartford",0,406,0,0,202,0,0,204,0,2018
"722",1863,"Dubuque",124,4795,2.59,55,2324,2.37,69,2471,2.79,2018
"723",1908,"Dunkerton",2,203,0.99,1,105,0.95,1,98,1.02,2018
"724",1917,"Boyer Valley",3,192,1.56,0,90,0,3,102,2.94,2018
"725",1926,"Durant",4,331,1.21,0,163,0,4,168,2.38,2018
"726",1944,"Eagle Grove",17,406,4.19,4,208,1.92,13,198,6.57,2018
"727",1953,"Earlham",1,276,0.36,0,122,0,1,154,0.65,2018
"728",1963,"East Buchanan",5,273,1.83,2,130,1.54,3,143,2.1,2018
"729",1965,"Easton Valley",3,233,1.29,1,107,0.93,2,126,1.59,2018
"730",1968,"East Marshall",2,351,0.57,0,174,0,2,177,1.13,2018
"731",1970,"East Union",2,214,0.93,0,105,0,2,109,1.83,2018
"732",1972,"Eastern Allamakee",0,176,0,0,81,0,0,95,0,2018
"733",1975,"River Valley",3,190,1.58,1,92,1.09,2,98,2.04,2018
"734",1989,"Edgewood-Colesburg",1,231,0.43,1,109,0.92,0,122,0,2018
"735",2007,"Eldora-New Providence",3,280,1.07,1,127,0.79,2,153,1.31,2018
"736",2088,"Emmetsburg",12,405,2.96,2,196,1.02,10,209,4.78,2018
"737",2097,"English Valleys",2,205,0.98,1,100,1,1,105,0.95,2018
"738",2113,"Essex",2,90,2.22,1,47,2.13,1,43,2.33,2018
"739",2124,"Estherville Lincoln",16,597,2.68,7,297,2.36,9,300,3,2018
"740",2151,"Exira-Elk Horn-",1,176,0.57,0,78,0,1,98,1.02,2018
"741",2169,"Fairfield",25,775,3.23,13,369,3.52,12,406,2.96,2018
"742",2295,"Forest City",13,532,2.44,7,260,2.69,6,272,2.21,2018
"743",2313,"Fort Dodge",78,1644,4.74,30,768,3.91,48,876,5.48,2018
"744",2322,"Fort Madison",16,827,1.93,7,427,1.64,9,400,2.25,2018
"745",2369,"Fremont-Mills",0,206,0,0,94,0,0,112,0,2018
"746",2376,"Galva-Holstein",3,203,1.48,1,100,1,2,103,1.94,2018
"747",2403,"Garner-Hayfield-Ventura",2,468,0.43,0,217,0,2,251,0.8,2018
"748",2457,"George-Little Rock",1,208,0.48,0,83,0,1,125,0.8,2018
"749",2466,"Gilbert",0,756,0,0,360,0,0,396,0,2018
"750",2502,"Gladbrook-Reinbeck",2,214,0.93,0,107,0,2,107,1.87,2018
"751",2511,"Glenwood",8,966,0.83,4,434,0.92,4,532,0.75,2018
"752",2520,"Glidden-Ralston",0,131,0,0,63,0,0,68,0,2018
"753",2556,"Graettinger-Terril",2,152,1.32,1,70,1.43,1,82,1.22,2018
"754",2673,"Nodaway Valley",0,309,0,0,173,0,0,136,0,2018
"755",2682,"GMG",0,239,0,0,118,0,0,121,0,2018
"756",2709,"Grinnell-Newburg",7,767,0.91,3,355,0.85,4,412,0.97,2018
"757",2718,"Griswold",0,211,0,0,112,0,0,99,0,2018
"758",2727,"Grundy Center",1,309,0.32,0,149,0,1,160,0.63,2018
"759",2754,"Guthrie Center",4,242,1.65,2,128,1.56,2,114,1.75,2018
"760",2763,"Clayton Ridge",29,551,5.26,16,294,5.44,13,257,5.06,2018
"761",2766,"H-L-V",0,153,0,0,74,0,0,79,0,2018
"762",2772,"Hamburg",0,29,0,0,17,0,0,12,0,2018
"763",2781,"Hampton-Dumont",12,651,1.84,7,309,2.27,5,342,1.46,2018
"764",2826,"Harlan",5,744,0.67,2,356,0.56,3,388,0.77,2018
"765",2846,"Harris-Lake Park",2,151,1.32,1,66,1.52,1,85,1.18,2018
"766",2862,"Hartley-Melvin-Sanborn",1,286,0.35,1,126,0.79,0,160,0,2018
"767",2977,"Highland",2,285,0.7,1,131,0.76,1,154,0.65,2018
"768",2988,"Hinton",0,336,0,0,151,0,0,185,0,2018
"769",3029,"Howard-Winneshiek",8,578,1.38,3,273,1.1,5,305,1.64,2018
"770",3033,"Hubbard-Radcliffe",0,137,0,0,75,0,0,62,0,2018
"771",3042,"Hudson",0,324,0,0,155,0,0,169,0,2018
"772",3060,"Humboldt",7,723,0.97,2,370,0.54,5,353,1.42,2018
"773",3105,"Independence",12,697,1.72,8,352,2.27,4,345,1.16,2018
"774",3114,"Indianola",11,1672,0.66,5,827,0.6,6,845,0.71,2018
"775",3119,"Interstate 35",4,383,1.04,1,174,0.57,3,209,1.44,2018
"776",3141,"Iowa City",100,6238,1.6,37,3095,1.2,63,3143,2,2018
"777",3150,"Iowa Falls",6,640,0.94,3,335,0.9,3,305,0.98,2018
"778",3154,"Iowa Valley",0,247,0,0,120,0,0,127,0,2018
"779",3168,"IKM-Manning",3,304,0.99,1,147,0.68,2,157,1.27,2018
"780",3186,"Janesville Consolidated",0,161,0,0,80,0,0,81,0,2018
"781",3195,"Greene County",11,544,2.02,5,248,2.02,6,296,2.03,2018
"782",3204,"Jesup",1,425,0.24,0,204,0,1,221,0.45,2018
"783",3231,"Johnston",14,3356,0.42,7,1597,0.44,7,1759,0.4,2018
"784",3312,"Keokuk",23,812,2.83,12,404,2.97,11,408,2.7,2018
"785",3330,"Keota",2,134,1.49,1,59,1.69,1,75,1.33,2018
"786",3348,"Kingsley-Pierson",1,203,0.49,1,104,0.96,0,99,0,2018
"787",3375,"Knoxville",9,751,1.2,5,391,1.28,4,360,1.11,2018
"788",3420,"Lake Mills",9,321,2.8,7,163,4.29,2,158,1.27,2018
"789",3465,"Lamoni",1,146,0.68,1,70,1.43,0,76,0,2018
"790",3537,"Laurens-Marathon",0,27,0,0,15,0,0,12,0,2018
"791",3555,"Lawton-Bronson",0,286,0,0,141,0,0,145,0,2018
"792",3600,"Le Mars",6,1013,0.59,3,478,0.63,3,535,0.56,2018
"793",3609,"Lenox",2,207,0.97,0,102,0,2,105,1.9,2018
"794",3645,"Lewis Central",11,1394,0.79,5,690,0.72,6,704,0.85,2018
"795",3691,"North Cedar",8,345,2.32,3,166,1.81,5,179,2.79,2018
"796",3715,"Linn-Mar",47,3343,1.41,19,1611,1.18,28,1732,1.62,2018
"797",3744,"Lisbon",2,278,0.72,1,137,0.73,1,141,0.71,2018
"798",3798,"Logan-Magnolia",1,289,0.35,0,140,0,1,149,0.67,2018
"799",3816,"Lone Tree",2,215,0.93,0,107,0,2,108,1.85,2018
"800",3841,"Louisa-Muscatine",8,399,2.01,2,194,1.03,6,205,2.93,2018
"801",3906,"Lynnville-Sully",1,236,0.42,1,104,0.96,0,132,0,2018
"802",3942,"Madrid",1,307,0.33,0,147,0,1,160,0.63,2018
"803",3978,"East Mills",5,219,2.28,2,102,1.96,3,117,2.56,2018
"804",4023,"Manson Northwest Webster",5,340,1.47,2,167,1.2,3,173,1.73,2018
"805",4033,"Maple Valley-Anthon Oto",6,356,1.69,1,171,0.58,5,185,2.7,2018
"806",4041,"Maquoketa",8,742,1.08,4,352,1.14,4,390,1.03,2018
"807",4043,"Maquoketa Valley",0,300,0,0,163,0,0,137,0,2018
"808",4068,"Marcus-Meriden-Cleghorn",1,159,0.63,1,80,1.25,0,79,0,2018
"809",4086,"Marion Independent",10,1019,0.98,5,502,1,5,517,0.97,2018
"810",4104,"Marshalltown",55,2239,2.46,27,1075,2.51,28,1164,2.41,2018
"811",4122,"Martensdale-St Marys",0,258,0,0,101,0,0,157,0,2018
"812",4131,"Mason City",18,1648,1.09,5,808,0.62,13,840,1.55,2018
"813",4149,"MOC-Floyd Valley",13,663,1.96,6,319,1.88,7,344,2.03,2018
"814",4203,"Mediapolis",3,377,0.8,1,174,0.57,2,203,0.99,2018
"815",4212,"Melcher-Dallas",3,138,2.17,2,68,2.94,1,70,1.43,2018
"816",4269,"Midland",4,219,1.83,2,102,1.96,2,117,1.71,2018
"817",4271,"Mid-Prairie",3,562,0.53,1,265,0.38,2,297,0.67,2018
"818",4356,"Missouri Valley",3,368,0.82,2,181,1.1,1,187,0.53,2018
"819",4419,"MFL MarMac",3,331,0.91,1,167,0.6,2,164,1.22,2018
"820",4437,"Montezuma",0,219,0,0,116,0,0,103,0,2018
"821",4446,"Monticello",1,558,0.18,1,268,0.37,0,290,0,2018
"822",4491,"Moravia",4,189,2.12,1,93,1.08,3,96,3.13,2018
"823",4505,"Mormon Trail",7,100,7,3,50,6,4,50,8,2018
"824",4518,"Moulton-Udell",2,82,2.44,1,38,2.63,1,44,2.27,2018
"825",4527,"Mount Ayr",5,295,1.69,3,147,2.04,2,148,1.35,2018
"826",4536,"Mount Pleasant",20,914,2.19,8,457,1.75,12,457,2.63,2018
"827",4554,"Mount Vernon",4,642,0.62,1,305,0.33,3,337,0.89,2018
"828",4572,"Murray",3,134,2.24,1,68,1.47,2,66,3.03,2018
"829",4581,"Muscatine",97,2212,4.39,35,1108,3.16,62,1104,5.62,2018
"830",4599,"Nashua-Plainfield",0,248,0,0,120,0,0,128,0,2018
"831",4617,"Nevada",9,694,1.3,5,334,1.5,4,360,1.11,2018
"832",4644,"Newell-Fonda",3,221,1.36,0,109,0,3,112,2.68,2018
"833",4662,"New Hampton",6,489,1.23,4,262,1.53,2,227,0.88,2018
"834",4689,"New London",3,233,1.29,1,94,1.06,2,139,1.44,2018
"835",4725,"Newton",32,1376,2.33,14,680,2.06,18,696,2.59,2018
"836",4772,"Central Springs",1,331,0.3,0,160,0,1,171,0.58,2018
"837",4773,"Northeast",2,410,0.49,1,201,0.5,1,209,0.48,2018
"838",4774,"North Fayette Valley",9,478,1.88,0,228,0,9,250,3.6,2018
"839",4776,"North Mahaska",2,226,0.88,2,107,1.87,0,119,0,2018
"840",4777,"North Linn",2,299,0.67,1,141,0.71,1,158,0.63,2018
"841",4778,"North Kossuth",0,103,0,0,49,0,0,54,0,2018
"842",4779,"North Polk",4,750,0.53,1,366,0.27,3,384,0.78,2018
"843",4784,"North Scott",8,1466,0.55,5,723,0.69,3,743,0.4,2018
"844",4785,"North Tama County",1,220,0.45,1,104,0.96,0,116,0,2018
"845",4788,"Northwood-Kensett",0,235,0,0,109,0,0,126,0,2018
"846",4797,"Norwalk",7,1368,0.51,3,653,0.46,4,715,0.56,2018
"847",4860,"Odebolt Arthur Battle Creek Ida Grove",2,462,0.43,1,227,0.44,1,235,0.43,2018
"848",4869,"Oelwein",16,563,2.84,6,253,2.37,10,310,3.23,2018
"849",4878,"Ogden",0,318,0,0,148,0,0,170,0,2018
"850",4890,"Okoboji",3,452,0.66,1,229,0.44,2,223,0.9,2018
"851",4978,"Orient-Macksburg",1,81,1.23,1,36,2.78,0,45,0,2018
"852",4995,"Osage",1,420,0.24,0,208,0,1,212,0.47,2018
"853",5013,"Oskaloosa",15,979,1.53,6,442,1.36,9,537,1.68,2018
"854",5049,"Ottumwa",53,1881,2.82,20,924,2.16,33,957,3.45,2018
"855",5121,"Panorama",2,367,0.54,1,189,0.53,1,178,0.56,2018
"856",5139,"Paton-Churdan",0,96,0,0,48,0,0,48,0,2018
"857",5160,"PCM",1,490,0.2,1,223,0.45,0,267,0,2018
"858",5163,"Pekin",1,310,0.32,0,160,0,1,150,0.67,2018
"859",5166,"Pella",3,1071,0.28,2,504,0.4,1,567,0.18,2018
"860",5184,"Perry",8,822,0.97,3,409,0.73,5,413,1.21,2018
"861",5250,"Pleasant Valley",18,2206,0.82,9,1070,0.84,9,1136,0.79,2018
"862",5256,"Pleasantville",1,356,0.28,0,159,0,1,197,0.51,2018
"863",5283,"Pocahontas Area",9,396,2.27,2,187,1.07,7,209,3.35,2018
"864",5310,"Postville",7,318,2.2,3,159,1.89,4,159,2.52,2018
"865",5325,"Prairie Valley",6,336,1.79,2,156,1.28,4,180,2.22,2018
"866",5463,"Red Oak",9,470,1.91,4,217,1.84,5,253,1.98,2018
"867",5486,"Remsen-Union",0,93,0,0,49,0,0,44,0,2018
"868",5508,"Riceville",1,139,0.72,1,68,1.47,0,71,0,2018
"869",5510,"Riverside",0,261,0,0,110,0,0,151,0,2018
"870",5607,"Rock Valley",4,374,1.07,0,170,0,4,204,1.96,2018
"871",5643,"Roland-Story",3,521,0.58,0,253,0,3,268,1.12,2018
"872",5697,"Rudd-Rockford-Marble Rk",1,207,0.48,1,98,1.02,0,109,0,2018
"873",5724,"Ruthven-Ayrshire",0,81,0,0,42,0,0,39,0,2018
"874",5751,"St Ansgar",2,271,0.74,1,150,0.67,1,121,0.83,2018
"875",5805,"Saydel",4,614,0.65,3,285,1.05,1,329,0.3,2018
"876",5823,"Schaller-Crestland",0,129,0,0,61,0,0,68,0,2018
"877",5832,"Schleswig",1,36,2.78,0,21,0,1,15,6.67,2018
"878",5877,"Sergeant Bluff-Luton",0,758,0,0,364,0,0,394,0,2018
"879",5895,"Seymour",2,128,1.56,1,61,1.64,1,67,1.49,2018
"880",5922,"West Fork",1,286,0.35,1,139,0.72,0,147,0,2018
"881",5949,"Sheldon",6,514,1.17,2,241,0.83,4,273,1.47,2018
"882",5976,"Shenandoah",1,465,0.22,0,205,0,1,260,0.38,2018
"883",5994,"Sibley-Ocheyedan",6,380,1.58,1,179,0.56,5,201,2.49,2018
"884",6003,"Sidney",3,262,1.15,0,120,0,3,142,2.11,2018
"885",6012,"Sigourney",3,265,1.13,1,115,0.87,2,150,1.33,2018
"886",6030,"Sioux Center",32,596,5.37,6,293,2.05,26,303,8.58,2018
"887",6035,"Sioux Central",6,368,1.63,2,160,1.25,4,208,1.92,2018
"888",6039,"Sioux City",123,6341,1.94,45,3070,1.47,78,3271,2.38,2018
"889",6091,"South Central Calhoun",8,388,2.06,4,191,2.09,4,197,2.03,2018
"890",6093,"Solon",0,729,0,0,341,0,0,388,0,2018
"891",6094,"Southeast Warren",1,223,0.45,0,97,0,1,126,0.79,2018
"892",6095,"South Hamilton",5,364,1.37,3,178,1.69,2,186,1.08,2018
"893",6096,"Southeast Webster Grand",0,154,0,0,75,0,0,79,0,2018
"894",6097,"South Page",0,61,0,0,32,0,0,29,0,2018
"895",6098,"South Tama County",21,710,2.96,12,333,3.6,9,377,2.39,2018
"896",6099,"South O'Brien",4,298,1.34,0,134,0,4,164,2.44,2018
"897",6100,"South Winneshiek",1,264,0.38,0,127,0,1,137,0.73,2018
"898",6101,"Southeast Polk",31,3228,0.96,18,1612,1.12,13,1616,0.8,2018
"899",6102,"Spencer",11,990,1.11,6,501,1.2,5,489,1.02,2018
"900",6120,"Spirit Lake",7,569,1.23,2,278,0.72,5,291,1.72,2018
"901",6138,"Springville",4,178,2.25,2,86,2.33,2,92,2.17,2018
"902",6165,"Stanton",0,101,0,0,45,0,0,56,0,2018
"903",6175,"Starmont",3,268,1.12,1,142,0.7,2,126,1.59,2018
"904",6219,"Storm Lake",22,1166,1.89,4,545,0.73,18,621,2.9,2018
"905",6264,"West Central Valley",4,372,1.08,0,170,0,4,202,1.98,2018
"906",6273,"Sumner-Fredericksburg",6,375,1.6,3,206,1.46,3,169,1.78,2018
"907",6408,"Tipton",0,473,0,0,241,0,0,232,0,2018
"908",6453,"Treynor",0,401,0,0,195,0,0,206,0,2018
"909",6460,"Tri-Center",0,304,0,0,146,0,0,158,0,2018
"910",6462,"Tri-County",3,108,2.78,1,52,1.92,2,56,3.57,2018
"911",6471,"Tripoli",3,190,1.58,1,94,1.06,2,96,2.08,2018
"912",6509,"Turkey Valley",0,166,0,0,75,0,0,91,0,2018
"913",6512,"Twin Cedars",2,157,1.27,1,72,1.39,1,85,1.18,2018
"914",6534,"Underwood",1,401,0.25,1,171,0.58,0,230,0,2018
"915",6536,"Union",2,531,0.38,0,238,0,2,293,0.68,2018
"916",6579,"Urbandale",4,1936,0.21,2,931,0.21,2,1005,0.2,2018
"917",6592,"Van Buren",4,370,1.08,2,166,1.2,2,204,0.98,2018
"918",6615,"Van Meter",1,384,0.26,1,174,0.57,0,210,0,2018
"919",6651,"Villisca",0,109,0,0,60,0,0,49,0,2018
"920",6660,"Vinton-Shellsburg",6,672,0.89,4,344,1.16,2,328,0.61,2018
"921",6700,"Waco",0,207,0,0,95,0,0,112,0,2018
"922",6741,"East Sac County",5,397,1.26,3,201,1.49,2,196,1.02,2018
"923",6759,"Wapello",11,315,3.49,5,145,3.45,6,170,3.53,2018
"924",6762,"Wapsie Valley",0,307,0,0,158,0,0,149,0,2018
"925",6768,"Washington",15,786,1.91,3,364,0.82,12,422,2.84,2018
"926",6795,"Waterloo",137,4622,2.96,73,2304,3.17,64,2318,2.76,2018
"927",6822,"Waukee",10,4450,0.22,3,2255,0.13,7,2195,0.32,2018
"928",6840,"Waverly-Shell Rock",10,1117,0.9,1,531,0.19,9,586,1.54,2018
"929",6854,"Wayne",2,259,0.77,2,136,1.47,0,123,0,2018
"930",6867,"Webster City",12,841,1.43,4,399,1,8,442,1.81,2018
"931",6921,"West Bend-Mallard",1,159,0.63,0,67,0,1,92,1.09,2018
"932",6930,"West Branch",9,359,2.51,2,161,1.24,7,198,3.54,2018
"933",6937,"West Burlington Ind",3,450,0.67,1,227,0.44,2,223,0.9,2018
"934",6943,"West Central",1,118,0.85,1,65,1.54,0,53,0,2018
"935",6950,"West Delaware County",7,728,0.96,4,346,1.16,3,382,0.79,2018
"936",6957,"West Des Moines",57,4212,1.35,21,2068,1.02,36,2144,1.68,2018
"937",6961,"Western Dubuque",7,1653,0.42,0,788,0,7,865,0.81,2018
"938",6969,"West Harrison",0,152,0,0,74,0,0,78,0,2018
"939",6975,"West Liberty",15,578,2.6,4,287,1.39,11,291,3.78,2018
"940",6983,"West Lyon",3,418,0.72,0,193,0,3,225,1.33,2018
"941",6985,"West Marshall",2,464,0.43,1,222,0.45,1,242,0.41,2018
"942",6987,"West Monona",3,308,0.97,1,156,0.64,2,152,1.32,2018
"943",6990,"West Sioux",2,359,0.56,0,178,0,2,181,1.1,2018
"944",6992,"Westwood",2,268,0.75,1,138,0.72,1,130,0.77,2018
"945",7002,"Whiting",3,98,3.06,1,43,2.33,2,55,3.64,2018
"946",7029,"Williamsburg",0,533,0,0,261,0,0,272,0,2018
"947",7038,"Wilton",2,359,0.56,0,155,0,2,204,0.98,2018
"948",7047,"Winfield-Mt Union",1,221,0.45,1,105,0.95,0,116,0,2018
"949",7056,"Winterset",5,815,0.61,4,393,1.02,1,422,0.24,2018
"950",7092,"Woodbine",4,190,2.11,2,90,2.22,2,100,2,2018
"951",7098,"Woodbury Central",6,284,2.11,2,139,1.44,4,145,2.76,2018
"952",7110,"Woodward-Granger",2,547,0.37,1,209,0.48,1,338,0.3,2018
"953",9,"AGWSR",7,263,2.66,3,137,2.19,4,126,3.17,2019
"954",18,"Adair-Casey",0,109,0,0,51,0,0,58,0,2019
"955",27,"Adel DeSoto Minburn",3,848,0.35,0,436,0,3,412,0.73,2019
"956",63,"Akron Westfield",1,288,0.35,1,142,0.7,0,146,0,2019
"957",81,"Albia",8,567,1.41,3,278,1.08,5,289,1.73,2019
"958",99,"Alburnett",1,304,0.33,0,150,0,1,154,0.65,2019
"959",126,"Algona",3,663,0.45,1,323,0.31,2,340,0.59,2019
"960",135,"Allamakee",4,565,0.71,1,264,0.38,3,301,1,2019
"961",153,"North Butler",2,245,0.82,1,112,0.89,1,133,0.75,2019
"962",171,"Alta-Aurelia",3,317,0.95,2,169,1.18,1,148,0.68,2019
"963",225,"Ames",25,2066,1.21,8,1033,0.77,17,1033,1.65,2019
"964",234,"Anamosa",8,603,1.33,3,294,1.02,5,309,1.62,2019
"965",243,"Andrew",0,12,0,0,0,0,0,0,0,2019
"966",261,"Ankeny",13,5292,0.25,6,2612,0.23,7,2680,0.26,2019
"967",279,"Aplington-Parkersburg",5,368,1.36,2,188,1.06,3,180,1.67,2019
"968",333,"North Union",0,203,0,0,105,0,0,98,0,2019
"969",355,"Ar-We-Va",1,97,1.03,0,48,0,1,49,2.04,2019
"970",387,"Atlantic",15,647,2.32,3,308,0.97,12,339,3.54,2019
"971",414,"Audubon",2,220,0.91,1,107,0.93,1,113,0.88,2019
"972",441,"AHSTW",4,332,1.2,1,173,0.58,3,159,1.89,2019
"973",472,"Ballard",3,758,0.4,0,363,0,3,395,0.76,2019
"974",513,"Baxter",0,193,0,0,99,0,0,94,0,2019
"975",540,"BCLUW",2,262,0.76,2,120,1.67,0,142,0,2019
"976",549,"Bedford",1,199,0.5,0,87,0,1,112,0.89,2019
"977",576,"Belle Plaine",1,231,0.43,0,115,0,1,116,0.86,2019
"978",585,"Bellevue",2,335,0.6,0,166,0,2,169,1.18,2019
"979",594,"Belmond-Klemme",5,353,1.42,2,159,1.26,3,194,1.55,2019
"980",609,"Benton",7,710,0.99,3,336,0.89,4,374,1.07,2019
"981",621,"Bettendorf",12,2272,0.53,6,1092,0.55,6,1180,0.51,2019
"982",657,"Eddyville-Blakesburg-",3,437,0.69,1,209,0.48,2,228,0.88,2019
"983",720,"Bondurant-Farrar",5,1002,0.5,2,456,0.44,3,546,0.55,2019
"984",729,"Boone",6,977,0.61,2,454,0.44,4,523,0.76,2019
"985",747,"Boyden-Hull",6,320,1.88,3,157,1.91,3,163,1.84,2019
"986",819,"West Hancock",3,268,1.12,1,125,0.8,2,143,1.4,2019
"987",846,"Brooklyn-Guernsey-Malcom",2,233,0.86,0,129,0,2,104,1.92,2019
"988",873,"North Iowa",0,185,0,0,83,0,0,102,0,2019
"989",882,"Burlington",47,1579,2.98,17,777,2.19,30,802,3.74,2019
"990",914,"CAM",29,659,4.4,19,362,5.25,10,297,3.37,2019
"991",918,"Calamus-Wheatland",1,207,0.48,0,103,0,1,104,0.96,2019
"992",936,"Camanche",7,464,1.51,6,245,2.45,1,219,0.46,2019
"993",977,"Cardinal",1,397,0.25,0,205,0,1,192,0.52,2019
"994",981,"Carlisle",7,994,0.7,3,503,0.6,4,491,0.81,2019
"995",999,"Carroll",0,791,0,0,379,0,0,412,0,2019
"996",1044,"Cedar Falls",17,2521,0.67,5,1194,0.42,12,1327,0.9,2019
"997",1053,"Cedar Rapids",141,7284,1.94,63,3568,1.77,78,3716,2.1,2019
"998",1062,"Center Point-Urbana",4,727,0.55,1,349,0.29,3,378,0.79,2019
"999",1071,"Centerville",7,594,1.18,2,280,0.71,5,314,1.59,2019
"1000",1079,"Central Lee",2,489,0.41,1,235,0.43,1,254,0.39,2019
"1001",1080,"Central",0,205,0,0,123,0,0,82,0,2019
"1002",1082,"Central DeWitt",5,754,0.66,2,346,0.58,3,408,0.74,2019
"1003",1089,"Central City",1,203,0.49,0,101,0,1,102,0.98,2019
"1004",1093,"Central Decatur",1,314,0.32,1,154,0.65,0,160,0,2019
"1005",1095,"Central Lyon",2,349,0.57,1,166,0.6,1,183,0.55,2019
"1006",1107,"Chariton",3,562,0.53,2,274,0.73,1,288,0.35,2019
"1007",1116,"Charles City",8,814,0.98,4,405,0.99,4,409,0.98,2019
"1008",1134,"Charter Oak-Ute",0,46,0,0,23,0,0,23,0,2019
"1009",1152,"Cherokee",2,483,0.41,0,249,0,2,234,0.85,2019
"1010",1197,"Clarinda",4,483,0.83,1,215,0.47,3,268,1.12,2019
"1011",1206,"Clarion-Goldfield-Dows",8,431,1.86,3,219,1.37,5,212,2.36,2019
"1012",1211,"Clarke",14,627,2.23,5,277,1.81,9,350,2.57,2019
"1013",1215,"Clarksville",1,137,0.73,0,70,0,1,67,1.49,2019
"1014",1221,"Clear Creek Amana",12,1044,1.15,6,495,1.21,6,549,1.09,2019
"1015",1233,"Clear Lake",4,618,0.65,1,287,0.35,3,331,0.91,2019
"1016",1278,"Clinton",38,1439,2.64,14,688,2.03,24,751,3.2,2019
"1017",1332,"Colfax-Mingo",2,356,0.56,1,181,0.55,1,175,0.57,2019
"1018",1337,"College",38,2558,1.49,15,1242,1.21,23,1316,1.75,2019
"1019",1350,"Collins-Maxwell",1,177,0.56,0,82,0,1,95,1.05,2019
"1020",1359,"Colo-NESCO",0,194,0,0,99,0,0,95,0,2019
"1021",1368,"Columbus",3,298,1.01,0,126,0,3,172,1.74,2019
"1022",1413,"Coon Rapids-Bayard",3,176,1.7,1,89,1.12,2,87,2.3,2019
"1023",1431,"Corning",4,184,2.17,3,93,3.23,1,91,1.1,2019
"1024",1476,"Council Bluffs",80,3962,2.02,32,1934,1.65,48,2028,2.37,2019
"1025",1503,"Creston",5,714,0.7,4,350,1.14,1,364,0.27,2019
"1026",1576,"Dallas Center-Grimes",7,1340,0.52,0,658,0,7,682,1.03,2019
"1027",1602,"Danville",6,326,1.84,1,157,0.64,5,169,2.96,2019
"1028",1611,"Davenport",221,6737,3.28,98,3353,2.92,123,3384,3.63,2019
"1029",1619,"Davis County",3,576,0.52,3,291,1.03,0,285,0,2019
"1030",1638,"Decorah Community",6,854,0.7,3,427,0.7,3,427,0.7,2019
"1031",1701,"Denison",26,1125,2.31,9,549,1.64,17,576,2.95,2019
"1032",1719,"Denver",0,375,0,0,175,0,0,200,0,2019
"1033",1737,"Des Moines Independent",485,14346,3.38,199,6979,2.85,286,7367,3.88,2019
"1034",1782,"Diagonal",1,54,1.85,0,23,0,1,31,3.23,2019
"1035",1791,"Dike-New Hartford",1,411,0.24,1,220,0.45,0,191,0,2019
"1036",1863,"Dubuque",101,4832,2.09,35,2359,1.48,66,2473,2.67,2019
"1037",1908,"Dunkerton",2,206,0.97,1,108,0.93,1,98,1.02,2019
"1038",1917,"Boyer Valley",1,188,0.53,1,85,1.18,0,103,0,2019
"1039",1926,"Durant",9,321,2.8,3,150,2,6,171,3.51,2019
"1040",1944,"Eagle Grove",31,443,7,11,221,4.98,20,222,9.01,2019
"1041",1953,"Earlham",0,285,0,0,118,0,0,167,0,2019
"1042",1963,"East Buchanan",2,280,0.71,1,130,0.77,1,150,0.67,2019
"1043",1965,"Easton Valley",2,223,0.9,0,104,0,2,119,1.68,2019
"1044",1968,"East Marshall",4,364,1.1,1,182,0.55,3,182,1.65,2019
"1045",1970,"East Union",1,241,0.41,0,113,0,1,128,0.78,2019
"1046",1972,"Eastern Allamakee",0,169,0,0,75,0,0,94,0,2019
"1047",1975,"River Valley",2,182,1.1,0,85,0,2,97,2.06,2019
"1048",1989,"Edgewood-Colesburg",2,223,0.9,0,100,0,2,123,1.63,2019
"1049",2007,"Eldora-New Providence",5,254,1.97,3,109,2.75,2,145,1.38,2019
"1050",2088,"Emmetsburg",2,400,0.5,1,189,0.53,1,211,0.47,2019
"1051",2097,"English Valleys",1,192,0.52,0,95,0,1,97,1.03,2019
"1052",2113,"Essex",0,68,0,0,36,0,0,32,0,2019
"1053",2124,"Estherville Lincoln",5,591,0.85,4,294,1.36,1,297,0.34,2019
"1054",2151,"Exira-Elk Horn-",0,178,0,0,85,0,0,93,0,2019
"1055",2169,"Fairfield",18,749,2.4,4,346,1.16,14,403,3.47,2019
"1056",2295,"Forest City",7,515,1.36,3,256,1.17,4,259,1.54,2019
"1057",2313,"Fort Dodge",59,1614,3.66,30,756,3.97,29,858,3.38,2019
"1058",2322,"Fort Madison",11,853,1.29,5,438,1.14,6,415,1.45,2019
"1059",2369,"Fremont-Mills",0,214,0,0,104,0,0,110,0,2019
"1060",2376,"Galva-Holstein",3,207,1.45,2,101,1.98,1,106,0.94,2019
"1061",2403,"Garner-Hayfield-Ventura",4,461,0.87,3,208,1.44,1,253,0.4,2019
"1062",2457,"George-Little Rock",2,188,1.06,0,84,0,2,104,1.92,2019
"1063",2466,"Gilbert",1,745,0.13,0,358,0,1,387,0.26,2019
"1064",2502,"Gladbrook-Reinbeck",2,204,0.98,1,99,1.01,1,105,0.95,2019
"1065",2511,"Glenwood",5,894,0.56,2,404,0.5,3,490,0.61,2019
"1066",2520,"Glidden-Ralston",0,131,0,0,60,0,0,71,0,2019
"1067",2556,"Graettinger-Terril",0,144,0,0,64,0,0,80,0,2019
"1068",2673,"Nodaway Valley",2,305,0.66,1,165,0.61,1,140,0.71,2019
"1069",2682,"GMG",0,238,0,0,126,0,0,112,0,2019
"1070",2709,"Grinnell-Newburg",18,757,2.38,9,361,2.49,9,396,2.27,2019
"1071",2718,"Griswold",2,203,0.99,2,109,1.83,0,94,0,2019
"1072",2727,"Grundy Center",2,317,0.63,1,160,0.63,1,157,0.64,2019
"1073",2754,"Guthrie Center",2,240,0.83,1,115,0.87,1,125,0.8,2019
"1074",2763,"Clayton Ridge",16,672,2.38,8,375,2.13,8,297,2.69,2019
"1075",2766,"H-L-V",0,151,0,0,70,0,0,81,0,2019
"1076",2772,"Hamburg",1,28,3.57,0,14,0,1,14,7.14,2019
"1077",2781,"Hampton-Dumont",22,661,3.33,9,305,2.95,13,356,3.65,2019
"1078",2826,"Harlan",5,733,0.68,0,358,0,5,375,1.33,2019
"1079",2846,"Harris-Lake Park",1,152,0.66,0,66,0,1,86,1.16,2019
"1080",2862,"Hartley-Melvin-Sanborn",4,280,1.43,1,128,0.78,3,152,1.97,2019
"1081",2977,"Highland",2,275,0.73,1,131,0.76,1,144,0.69,2019
"1082",2988,"Hinton",1,352,0.28,1,165,0.61,0,187,0,2019
"1083",3029,"Howard-Winneshiek",2,583,0.34,1,267,0.37,1,316,0.32,2019
"1084",3033,"Hubbard-Radcliffe",0,137,0,0,64,0,0,73,0,2019
"1085",3042,"Hudson",0,355,0,0,175,0,0,180,0,2019
"1086",3060,"Humboldt",10,741,1.35,4,365,1.1,6,376,1.6,2019
"1087",3105,"Independence",6,668,0.9,1,333,0.3,5,335,1.49,2019
"1088",3114,"Indianola",16,1657,0.97,6,837,0.72,10,820,1.22,2019
"1089",3119,"Interstate 35",2,381,0.52,1,174,0.57,1,207,0.48,2019
"1090",3141,"Iowa City",87,6437,1.35,35,3178,1.1,52,3259,1.6,2019
"1091",3150,"Iowa Falls",15,625,2.4,7,316,2.22,8,309,2.59,2019
"1092",3154,"Iowa Valley",0,247,0,0,116,0,0,131,0,2019
"1093",3168,"IKM-Manning",0,290,0,0,139,0,0,151,0,2019
"1094",3186,"Janesville Consolidated",1,169,0.59,1,89,1.12,0,80,0,2019
"1095",3195,"Greene County",5,558,0.9,2,254,0.79,3,304,0.99,2019
"1096",3204,"Jesup",1,451,0.22,1,222,0.45,0,229,0,2019
"1097",3231,"Johnston",7,3352,0.21,2,1593,0.13,5,1759,0.28,2019
"1098",3312,"Keokuk",19,830,2.29,7,403,1.74,12,427,2.81,2019
"1099",3330,"Keota",2,136,1.47,2,58,3.45,0,78,0,2019
"1100",3348,"Kingsley-Pierson",0,194,0,0,106,0,0,88,0,2019
"1101",3375,"Knoxville",13,765,1.7,6,381,1.57,7,384,1.82,2019
"1102",3420,"Lake Mills",5,323,1.55,2,159,1.26,3,164,1.83,2019
"1103",3465,"Lamoni",2,152,1.32,1,69,1.45,1,83,1.2,2019
"1104",3537,"Laurens-Marathon",0,25,0,0,16,0,0,0,0,2019
"1105",3555,"Lawton-Bronson",0,312,0,0,148,0,0,164,0,2019
"1106",3600,"Le Mars",12,1023,1.17,3,490,0.61,9,533,1.69,2019
"1107",3609,"Lenox",0,216,0,0,102,0,0,114,0,2019
"1108",3645,"Lewis Central",7,1379,0.51,2,674,0.3,5,705,0.71,2019
"1109",3691,"North Cedar",2,312,0.64,1,151,0.66,1,161,0.62,2019
"1110",3715,"Linn-Mar",32,3400,0.94,5,1684,0.3,27,1716,1.57,2019
"1111",3744,"Lisbon",2,282,0.71,2,129,1.55,0,153,0,2019
"1112",3798,"Logan-Magnolia",0,290,0,0,144,0,0,146,0,2019
"1113",3816,"Lone Tree",2,214,0.93,0,102,0,2,112,1.79,2019
"1114",3841,"Louisa-Muscatine",5,397,1.26,3,193,1.55,2,204,0.98,2019
"1115",3906,"Lynnville-Sully",1,240,0.42,1,111,0.9,0,129,0,2019
"1116",3942,"Madrid",3,316,0.95,2,145,1.38,1,171,0.58,2019
"1117",3978,"East Mills",2,206,0.97,1,99,1.01,1,107,0.93,2019
"1118",4023,"Manson Northwest Webster",0,349,0,0,163,0,0,186,0,2019
"1119",4033,"Maple Valley-Anthon Oto",4,353,1.13,2,169,1.18,2,184,1.09,2019
"1120",4041,"Maquoketa",7,740,0.95,1,359,0.28,6,381,1.57,2019
"1121",4043,"Maquoketa Valley",1,293,0.34,1,156,0.64,0,137,0,2019
"1122",4068,"Marcus-Meriden-Cleghorn",2,165,1.21,1,84,1.19,1,81,1.23,2019
"1123",4086,"Marion Independent",8,1007,0.79,2,511,0.39,6,496,1.21,2019
"1124",4104,"Marshalltown",65,2331,2.79,23,1124,2.05,42,1207,3.48,2019
"1125",4122,"Martensdale-St Marys",0,244,0,0,102,0,0,142,0,2019
"1126",4131,"Mason City",30,1630,1.84,12,806,1.49,18,824,2.18,2019
"1127",4149,"MOC-Floyd Valley",10,650,1.54,7,308,2.27,3,342,0.88,2019
"1128",4203,"Mediapolis",9,374,2.41,5,167,2.99,4,207,1.93,2019
"1129",4212,"Melcher-Dallas",2,155,1.29,0,82,0,2,73,2.74,2019
"1130",4269,"Midland",3,230,1.3,1,114,0.88,2,116,1.72,2019
"1131",4271,"Mid-Prairie",9,597,1.51,5,285,1.75,4,312,1.28,2019
"1132",4356,"Missouri Valley",2,369,0.54,1,172,0.58,1,197,0.51,2019
"1133",4419,"MFL MarMac",0,324,0,0,151,0,0,173,0,2019
"1134",4437,"Montezuma",4,214,1.87,1,116,0.86,3,98,3.06,2019
"1135",4446,"Monticello",3,550,0.55,2,260,0.77,1,290,0.34,2019
"1136",4491,"Moravia",1,185,0.54,0,87,0,1,98,1.02,2019
"1137",4505,"Mormon Trail",1,86,1.16,1,44,2.27,0,42,0,2019
"1138",4518,"Moulton-Udell",0,80,0,0,40,0,0,40,0,2019
"1139",4527,"Mount Ayr",2,293,0.68,0,145,0,2,148,1.35,2019
"1140",4536,"Mount Pleasant",19,886,2.14,6,436,1.38,13,450,2.89,2019
"1141",4554,"Mount Vernon",2,648,0.31,1,313,0.32,1,335,0.3,2019
"1142",4572,"Murray",2,127,1.57,0,61,0,2,66,3.03,2019
"1143",4581,"Muscatine",48,2193,2.19,20,1092,1.83,28,1101,2.54,2019
"1144",4599,"Nashua-Plainfield",0,249,0,0,116,0,0,133,0,2019
"1145",4617,"Nevada",2,704,0.28,0,335,0,2,369,0.54,2019
"1146",4644,"Newell-Fonda",0,234,0,0,111,0,0,123,0,2019
"1147",4662,"New Hampton",3,476,0.63,2,248,0.81,1,228,0.44,2019
"1148",4689,"New London",0,247,0,0,105,0,0,142,0,2019
"1149",4725,"Newton",16,1355,1.18,7,671,1.04,9,684,1.32,2019
"1150",4772,"Central Springs",2,318,0.63,1,157,0.64,1,161,0.62,2019
"1151",4773,"Northeast",0,427,0,0,213,0,0,214,0,2019
"1152",4774,"North Fayette Valley",14,473,2.96,3,225,1.33,11,248,4.44,2019
"1153",4776,"North Mahaska",5,271,1.85,3,131,2.29,2,140,1.43,2019
"1154",4777,"North Linn",0,286,0,0,135,0,0,151,0,2019
"1155",4778,"North Kossuth",0,119,0,0,55,0,0,64,0,2019
"1156",4779,"North Polk",5,813,0.62,0,393,0,5,420,1.19,2019
"1157",4784,"North Scott",11,1465,0.75,5,725,0.69,6,740,0.81,2019
"1158",4785,"North Tama County",1,224,0.45,1,104,0.96,0,120,0,2019
"1159",4788,"Northwood-Kensett",1,248,0.4,0,115,0,1,133,0.75,2019
"1160",4797,"Norwalk",6,1419,0.42,4,703,0.57,2,716,0.28,2019
"1161",4860,"Odebolt Arthur Battle Creek Ida Grove",5,479,1.04,4,231,1.73,1,248,0.4,2019
"1162",4869,"Oelwein",10,577,1.73,4,255,1.57,6,322,1.86,2019
"1163",4878,"Ogden",4,339,1.18,0,152,0,4,187,2.14,2019
"1164",4890,"Okoboji",2,504,0.4,0,247,0,2,257,0.78,2019
"1165",4978,"Orient-Macksburg",1,69,1.45,0,32,0,1,37,2.7,2019
"1166",4995,"Osage",2,428,0.47,1,209,0.48,1,219,0.46,2019
"1167",5013,"Oskaloosa",12,940,1.28,6,430,1.4,6,510,1.18,2019
"1168",5049,"Ottumwa",34,1932,1.76,10,926,1.08,24,1006,2.39,2019
"1169",5121,"Panorama",4,375,1.07,1,180,0.56,3,195,1.54,2019
"1170",5139,"Paton-Churdan",1,98,1.02,0,52,0,1,46,2.17,2019
"1171",5160,"PCM",0,501,0,0,217,0,0,284,0,2019
"1172",5163,"Pekin",0,319,0,0,164,0,0,155,0,2019
"1173",5166,"Pella",8,1074,0.74,1,492,0.2,7,582,1.2,2019
"1174",5184,"Perry",6,845,0.71,2,411,0.49,4,434,0.92,2019
"1175",5250,"Pleasant Valley",10,2324,0.43,2,1128,0.18,8,1196,0.67,2019
"1176",5256,"Pleasantville",1,353,0.28,0,154,0,1,199,0.5,2019
"1177",5283,"Pocahontas Area",12,390,3.08,6,184,3.26,6,206,2.91,2019
"1178",5310,"Postville",10,358,2.79,6,183,3.28,4,175,2.29,2019
"1179",5325,"Prairie Valley",1,306,0.33,0,136,0,1,170,0.59,2019
"1180",5463,"Red Oak",2,488,0.41,1,249,0.4,1,239,0.42,2019
"1181",5486,"Remsen-Union",0,100,0,0,52,0,0,48,0,2019
"1182",5508,"Riceville",1,154,0.65,0,71,0,1,83,1.2,2019
"1183",5510,"Riverside",2,259,0.77,1,114,0.88,1,145,0.69,2019
"1184",5607,"Rock Valley",7,395,1.77,3,182,1.65,4,213,1.88,2019
"1185",5643,"Roland-Story",0,498,0,0,235,0,0,263,0,2019
"1186",5697,"Rudd-Rockford-Marble Rk",0,201,0,0,87,0,0,114,0,2019
"1187",5724,"Ruthven-Ayrshire",2,83,2.41,0,46,0,2,37,5.41,2019
"1188",5751,"St Ansgar",1,254,0.39,1,135,0.74,0,119,0,2019
"1189",5805,"Saydel",11,644,1.71,2,301,0.66,9,343,2.62,2019
"1190",5823,"Schaller-Crestland",0,132,0,0,62,0,0,70,0,2019
"1191",5832,"Schleswig",0,29,0,0,19,0,0,10,0,2019
"1192",5877,"Sergeant Bluff-Luton",3,772,0.39,0,371,0,3,401,0.75,2019
"1193",5895,"Seymour",0,127,0,0,64,0,0,63,0,2019
"1194",5922,"West Fork",4,292,1.37,1,138,0.72,3,154,1.95,2019
"1195",5949,"Sheldon",4,507,0.79,1,236,0.42,3,271,1.11,2019
"1196",5976,"Shenandoah",0,479,0,0,218,0,0,261,0,2019
"1197",5994,"Sibley-Ocheyedan",13,365,3.56,4,178,2.25,9,187,4.81,2019
"1198",6003,"Sidney",1,253,0.4,1,115,0.87,0,138,0,2019
"1199",6012,"Sigourney",0,265,0,0,126,0,0,139,0,2019
"1200",6030,"Sioux Center",34,647,5.26,21,324,6.48,13,323,4.02,2019
"1201",6035,"Sioux Central",15,366,4.1,4,161,2.48,11,205,5.37,2019
"1202",6039,"Sioux City",143,6584,2.17,56,3204,1.75,87,3380,2.57,2019
"1203",6091,"South Central Calhoun",1,374,0.27,0,187,0,1,187,0.53,2019
"1204",6093,"Solon",2,710,0.28,0,337,0,2,373,0.54,2019
"1205",6094,"Southeast Warren",1,239,0.42,0,110,0,1,129,0.78,2019
"1206",6095,"South Hamilton",1,353,0.28,1,165,0.61,0,188,0,2019
"1207",6096,"Southeast Webster Grand",0,174,0,0,94,0,0,80,0,2019
"1208",6097,"South Page",2,43,4.65,1,23,4.35,1,20,5,2019
"1209",6098,"South Tama County",20,703,2.84,6,325,1.85,14,378,3.7,2019
"1210",6099,"South O'Brien",6,290,2.07,3,133,2.26,3,157,1.91,2019
"1211",6100,"South Winneshiek",2,261,0.77,1,111,0.9,1,150,0.67,2019
"1212",6101,"Southeast Polk",44,3279,1.34,18,1588,1.13,26,1691,1.54,2019
"1213",6102,"Spencer",6,1048,0.57,3,514,0.58,3,534,0.56,2019
"1214",6120,"Spirit Lake",3,561,0.53,0,268,0,3,293,1.02,2019
"1215",6138,"Springville",5,189,2.65,2,91,2.2,3,98,3.06,2019
"1216",6165,"Stanton",0,113,0,0,49,0,0,64,0,2019
"1217",6175,"Starmont",3,280,1.07,2,143,1.4,1,137,0.73,2019
"1218",6219,"Storm Lake",26,1167,2.23,3,553,0.54,23,614,3.75,2019
"1219",6264,"West Central Valley",3,386,0.78,0,182,0,3,204,1.47,2019
"1220",6273,"Sumner-Fredericksburg",3,375,0.8,0,209,0,3,166,1.81,2019
"1221",6408,"Tipton",7,486,1.44,3,247,1.21,4,239,1.67,2019
"1222",6453,"Treynor",0,384,0,0,182,0,0,202,0,2019
"1223",6460,"Tri-Center",1,306,0.33,1,147,0.68,0,159,0,2019
"1224",6462,"Tri-County",2,114,1.75,2,58,3.45,0,56,0,2019
"1225",6471,"Tripoli",3,188,1.6,0,93,0,3,95,3.16,2019
"1226",6509,"Turkey Valley",1,178,0.56,1,89,1.12,0,89,0,2019
"1227",6512,"Twin Cedars",3,156,1.92,2,67,2.99,1,89,1.12,2019
"1228",6534,"Underwood",2,376,0.53,0,169,0,2,207,0.97,2019
"1229",6536,"Union",1,505,0.2,0,228,0,1,277,0.36,2019
"1230",6579,"Urbandale",5,1957,0.26,2,940,0.21,3,1017,0.29,2019
"1231",6592,"Van Buren County",6,344,1.74,3,161,1.86,3,183,1.64,2019
"1232",6615,"Van Meter",1,385,0.26,0,173,0,1,212,0.47,2019
"1233",6651,"Villisca",0,116,0,0,61,0,0,55,0,2019
"1234",6660,"Vinton-Shellsburg",15,683,2.2,7,360,1.94,8,323,2.48,2019
"1235",6700,"Waco",2,222,0.9,1,103,0.97,1,119,0.84,2019
"1236",6741,"East Sac County",1,375,0.27,0,186,0,1,189,0.53,2019
"1237",6759,"Wapello",3,290,1.03,0,135,0,3,155,1.94,2019
"1238",6762,"Wapsie Valley",1,316,0.32,1,161,0.62,0,155,0,2019
"1239",6768,"Washington",12,776,1.55,4,379,1.06,8,397,2.02,2019
"1240",6795,"Waterloo",91,4719,1.93,38,2353,1.61,53,2366,2.24,2019
"1241",6822,"Waukee",8,4714,0.17,2,2355,0.08,6,2359,0.25,2019
"1242",6840,"Waverly-Shell Rock",13,1128,1.15,6,523,1.15,7,605,1.16,2019
"1243",6854,"Wayne",2,265,0.75,0,138,0,2,127,1.57,2019
"1244",6867,"Webster City",22,866,2.54,9,405,2.22,13,461,2.82,2019
"1245",6921,"West Bend-Mallard",3,165,1.82,1,74,1.35,2,91,2.2,2019
"1246",6930,"West Branch",2,367,0.54,1,165,0.61,1,202,0.5,2019
"1247",6937,"West Burlington Ind",6,455,1.32,0,228,0,6,227,2.64,2019
"1248",6943,"West Central",0,124,0,0,69,0,0,55,0,2019
"1249",6950,"West Delaware County",10,737,1.36,4,359,1.11,6,378,1.59,2019
"1250",6957,"West Des Moines",45,4291,1.05,19,2107,0.9,26,2184,1.19,2019
"1251",6961,"Western Dubuque",1,1634,0.06,0,791,0,1,843,0.12,2019
"1252",6969,"West Harrison",3,140,2.14,0,65,0,3,75,4,2019
"1253",6975,"West Liberty",14,565,2.48,4,279,1.43,10,286,3.5,2019
"1254",6983,"West Lyon",2,451,0.44,1,205,0.49,1,246,0.41,2019
"1255",6985,"West Marshall",0,474,0,0,240,0,0,234,0,2019
"1256",6987,"West Monona",7,310,2.26,4,155,2.58,3,155,1.94,2019
"1257",6990,"West Sioux",1,398,0.25,0,199,0,1,199,0.5,2019
"1258",6992,"Westwood",1,271,0.37,1,131,0.76,0,140,0,2019
"1259",7002,"Whiting",0,82,0,0,43,0,0,39,0,2019
"1260",7029,"Williamsburg",0,553,0,0,280,0,0,273,0,2019
"1261",7038,"Wilton",7,386,1.81,2,178,1.12,5,208,2.4,2019
"1262",7047,"Winfield-Mt Union",1,214,0.47,0,96,0,1,118,0.85,2019
"1263",7056,"Winterset",1,823,0.12,0,393,0,1,430,0.23,2019
"1264",7092,"Woodbine",2,193,1.04,1,84,1.19,1,109,0.92,2019
"1265",7098,"Woodbury Central",2,288,0.69,1,150,0.67,1,138,0.72,2019
"1266",7110,"Woodward-Granger",3,366,0.82,2,182,1.1,1,184,0.54,2019
"1267",9,"AGWSR Comm School District",5,283,1.77,1,150,0.67,4,133,3.01,2020
"1268",18,"Adair-Casey Comm School District",0,108,0,0,44,0,0,64,0,2020
"1269",27,"Adel DeSoto Minburn Comm School District",6,883,0.68,1,449,0.22,5,434,1.15,2020
"1270",63,"Akron Westfield Comm School District",0,266,0,0,132,0,0,134,0,2020
"1271",81,"Albia Comm School District",2,571,0.35,1,281,0.36,1,290,0.34,2020
"1272",99,"Alburnett Comm School District",5,328,1.52,1,159,0.63,4,169,2.37,2020
"1273",126,"Algona Comm School District",14,666,2.1,7,313,2.24,7,353,1.98,2020
"1274",135,"Allamakee Comm School District",1,573,0.17,0,266,0,1,307,0.33,2020
"1275",153,"North Butler Comm School District",2,270,0.74,1,125,0.8,1,145,0.69,2020
"1276",171,"Alta-Aurelia Comm School District",5,323,1.55,2,169,1.18,3,154,1.95,2020
"1277",225,"Ames Comm School District",15,2093,0.72,8,1046,0.76,7,1047,0.67,2020
"1278",234,"Anamosa Comm School District",7,603,1.16,3,299,1,4,304,1.32,2020
"1279",243,"Andrew Comm School District",0,16,0,0,0,0,0,0,0,2020
"1280",261,"Ankeny Comm School District",34,5441,0.62,11,2675,0.41,23,2766,0.83,2020
"1281",279,"Aplington-Parkersburg Comm School District",0,370,0,0,191,0,0,179,0,2020
"1282",333,"North Union Comm School District",3,211,1.42,2,107,1.87,1,104,0.96,2020
"1283",355,"Ar-We-Va Comm School District",0,97,0,0,46,0,0,51,0,2020
"1284",387,"Atlantic Comm School District",13,665,1.95,6,325,1.85,7,340,2.06,2020
"1285",414,"Audubon Comm School District",0,212,0,0,107,0,0,105,0,2020
"1286",441,"AHSTW Comm School District",6,324,1.85,4,168,2.38,2,156,1.28,2020
"1287",472,"Ballard Comm School District",4,750,0.53,1,353,0.28,3,397,0.76,2020
"1288",513,"Baxter Comm School District",1,200,0.5,0,99,0,1,101,0.99,2020
"1289",540,"BCLUW Comm School District",5,277,1.81,0,126,0,5,151,3.31,2020
"1290",549,"Bedford Comm School District",2,206,0.97,0,96,0,2,110,1.82,2020
"1291",576,"Belle Plaine Comm School District",5,212,2.36,3,102,2.94,2,110,1.82,2020
"1292",585,"Bellevue Comm School District",2,314,0.64,1,157,0.64,1,157,0.64,2020
"1293",594,"Belmond-Klemme Comm School District",5,357,1.4,2,163,1.23,3,194,1.55,2020
"1294",609,"Benton Comm School District",10,716,1.4,4,320,1.25,6,396,1.52,2020
"1295",621,"Bettendorf Comm School District",21,2255,0.93,6,1076,0.56,15,1179,1.27,2020
"1296",657,"Eddyville-Blakesburg- Fremont CSD",8,427,1.87,1,196,0.51,7,231,3.03,2020
"1297",720,"Bondurant-Farrar Comm School District",7,1040,0.67,2,492,0.41,5,548,0.91,2020
"1298",729,"Boone Comm School District",5,976,0.51,4,451,0.89,1,525,0.19,2020
"1299",747,"Boyden-Hull Comm School District",4,325,1.23,1,160,0.63,3,165,1.82,2020
"1300",819,"West Hancock Comm School District",4,255,1.57,0,120,0,4,135,2.96,2020
"1301",846,"Brooklyn-Guernsey-Malcom Comm School District",1,246,0.41,1,131,0.76,0,115,0,2020
"1302",873,"North Iowa Comm School District",3,168,1.79,2,71,2.82,1,97,1.03,2020
"1303",882,"Burlington Comm School District",76,1550,4.9,33,759,4.35,43,791,5.44,2020
"1304",914,"CAM Comm School District",57,834,6.83,36,450,8,21,384,5.47,2020
"1305",918,"Calamus-Wheatland Comm School District",5,213,2.35,1,111,0.9,4,102,3.92,2020
"1306",936,"Camanche Comm School District",1,439,0.23,0,216,0,1,223,0.45,2020
"1307",977,"Cardinal Comm School District",3,408,0.74,2,208,0.96,1,200,0.5,2020
"1308",981,"Carlisle Comm School District",6,1056,0.57,3,535,0.56,3,521,0.58,2020
"1309",999,"Carroll Comm School District",12,827,1.45,4,382,1.05,8,445,1.8,2020
"1310",1044,"Cedar Falls Comm School District",26,2572,1.01,9,1220,0.74,17,1352,1.26,2020
"1311",1053,"Cedar Rapids Comm School District",224,7128,3.14,89,3489,2.55,135,3638,3.71,2020
"1312",1062,"Center Point-Urbana Comm School District",9,708,1.27,3,335,0.9,6,373,1.61,2020
"1313",1071,"Centerville Comm School District",8,589,1.36,4,287,1.39,4,302,1.32,2020
"1314",1079,"Central Lee Comm School District",3,490,0.61,1,242,0.41,2,248,0.81,2020
"1315",1080,"Central Comm School District",2,206,0.97,1,117,0.85,1,89,1.12,2020
"1316",1082,"Central DeWitt School District",8,761,1.05,3,339,0.88,5,422,1.18,2020
"1317",1089,"Central City Comm School District",5,212,2.36,1,111,0.9,4,101,3.96,2020
"1318",1093,"Central Decatur Comm School District",3,344,0.87,2,163,1.23,1,181,0.55,2020
"1319",1095,"Central Lyon Comm School District",1,342,0.29,0,159,0,1,183,0.55,2020
"1320",1107,"Chariton Comm School District",6,573,1.05,1,284,0.35,5,289,1.73,2020
"1321",1116,"Charles City Comm School District",28,831,3.37,12,410,2.93,16,421,3.8,2020
"1322",1134,"Charter Oak-Ute Comm School District",0,50,0,0,26,0,0,24,0,2020
"1323",1152,"Cherokee Comm School District",5,497,1.01,1,264,0.38,4,233,1.72,2020
"1324",1197,"Clarinda Comm School District",7,474,1.48,4,209,1.91,3,265,1.13,2020
"1325",1206,"Clarion-Goldfield-Dows Comm School District",6,440,1.36,3,229,1.31,3,211,1.42,2020
"1326",1211,"Clarke Comm School District",15,637,2.35,4,283,1.41,11,354,3.11,2020
"1327",1215,"Clarksville Comm School District",1,130,0.77,0,67,0,1,63,1.59,2020
"1328",1221,"Clear Creek Amana Comm School District",18,1091,1.65,10,515,1.94,8,576,1.39,2020
"1329",1233,"Clear Lake Comm School District",16,660,2.42,4,318,1.26,12,342,3.51,2020
"1330",1278,"Clinton Comm School District",58,1465,3.96,27,696,3.88,31,769,4.03,2020
"1331",1332,"Colfax-Mingo Comm School District",5,338,1.48,0,173,0,5,165,3.03,2020
"1332",1337,"College Comm School District",33,2540,1.3,11,1224,0.9,22,1316,1.67,2020
"1333",1350,"Collins-Maxwell Comm School District",2,181,1.1,0,81,0,2,100,2,2020
"1334",1359,"Colo-NESCO  Comm School District",1,192,0.52,0,86,0,1,106,0.94,2020
"1335",1368,"Columbus Comm School District",3,294,1.02,1,130,0.77,2,164,1.22,2020
"1336",1413,"Coon Rapids-Bayard Comm School District",0,180,0,0,88,0,0,92,0,2020
"1337",1431,"Corning Comm School District",3,194,1.55,1,95,1.05,2,99,2.02,2020
"1338",1476,"Council Bluffs Comm School District",107,3938,2.72,37,1887,1.96,70,2051,3.41,2020
"1339",1503,"Creston Comm School District",9,741,1.21,5,355,1.41,4,386,1.04,2020
"1340",1576,"Dallas Center-Grimes Comm School District",14,1404,1,7,723,0.97,7,681,1.03,2020
"1341",1602,"Danville  Comm School District",2,309,0.65,2,140,1.43,0,169,0,2020
"1342",1611,"Davenport Comm School District",264,6690,3.95,105,3305,3.18,159,3385,4.7,2020
"1343",1619,"Davis County Comm School District",2,603,0.33,2,296,0.68,0,307,0,2020
"1344",1638,"Decorah Community School District",5,824,0.61,1,415,0.24,4,409,0.98,2020
"1345",1701,"Denison Comm School District",21,1122,1.87,10,560,1.79,11,562,1.96,2020
"1346",1719,"Denver Comm School District",1,386,0.26,1,182,0.55,0,204,0,2020
"1347",1737,"Des Moines Independent Comm School District",733,14344,5.11,289,7027,4.11,444,7317,6.07,2020
"1348",1782,"Diagonal Comm School District",0,55,0,0,31,0,0,24,0,2020
"1349",1791,"Dike-New Hartford Comm School District",2,406,0.49,1,203,0.49,1,203,0.49,2020
"1350",1863,"Dubuque Comm School District",189,4826,3.92,73,2362,3.09,116,2464,4.71,2020
"1351",1908,"Dunkerton Comm School District",1,204,0.49,0,110,0,1,94,1.06,2020
"1352",1917,"Boyer Valley Comm School District",3,183,1.64,0,85,0,3,98,3.06,2020
"1353",1926,"Durant Comm School District",12,323,3.72,4,142,2.82,8,181,4.42,2020
"1354",1944,"Eagle Grove Comm School District",15,425,3.53,6,224,2.68,9,201,4.48,2020
"1355",1953,"Earlham Comm School District",1,297,0.34,1,130,0.77,0,167,0,2020
"1356",1963,"East Buchanan Comm School District",5,286,1.75,0,134,0,5,152,3.29,2020
"1357",1965,"Easton Valley Comm School District",3,213,1.41,1,98,1.02,2,115,1.74,2020
"1358",1968,"East Marshall Comm School District",4,385,1.04,0,191,0,4,194,2.06,2020
"1359",1970,"East Union Comm School District",1,254,0.39,0,115,0,1,139,0.72,2020
"1360",1972,"Eastern Allamakee Comm School District",1,155,0.65,0,65,0,1,90,1.11,2020
"1361",1975,"River Valley Comm School District",1,189,0.53,1,92,1.09,0,97,0,2020
"1362",1989,"Edgewood-Colesburg Comm School District",0,227,0,0,105,0,0,122,0,2020
"1363",2007,"Eldora-New Providence Comm School District",15,241,6.22,4,107,3.74,11,134,8.21,2020
"1364",2088,"Emmetsburg Comm School District",5,372,1.34,1,171,0.58,4,201,1.99,2020
"1365",2097,"English Valleys Comm School District",4,203,1.97,2,96,2.08,2,107,1.87,2020
"1366",2113,"Essex Comm School District",0,85,0,0,41,0,0,44,0,2020
"1367",2124,"Estherville Lincoln Central Com Sch Dist",13,580,2.24,5,289,1.73,8,291,2.75,2020
"1368",2151,"Exira-Elk Horn- Kimballton Comm Sch Dist",1,160,0.63,0,76,0,1,84,1.19,2020
"1369",2169,"Fairfield Comm School District",28,770,3.64,13,351,3.7,15,419,3.58,2020
"1370",2295,"Forest City Comm School District",18,480,3.75,5,235,2.13,13,245,5.31,2020
"1371",2313,"Fort Dodge Comm School District",110,1646,6.68,47,759,6.19,63,887,7.1,2020
"1372",2322,"Fort Madison Comm School District",33,845,3.91,16,444,3.6,17,401,4.24,2020
"1373",2369,"Fremont-Mills Comm School District",1,217,0.46,0,108,0,1,109,0.92,2020
"1374",2376,"Galva-Holstein Comm School District",4,227,1.76,0,108,0,4,119,3.36,2020
"1375",2403,"Garner-Hayfield-Ventura Comm School District",3,454,0.66,2,209,0.96,1,245,0.41,2020
"1376",2457,"George-Little Rock Comm School District",4,179,2.23,0,86,0,4,93,4.3,2020
"1377",2466,"Gilbert Comm School District",4,781,0.51,0,377,0,4,404,0.99,2020
"1378",2502,"Gladbrook-Reinbeck Comm School District",2,206,0.97,2,101,1.98,0,105,0,2020
"1379",2511,"Glenwood Comm School District",12,898,1.34,5,421,1.19,7,477,1.47,2020
"1380",2520,"Glidden-Ralston Comm School District",2,132,1.52,0,56,0,2,76,2.63,2020
"1381",2556,"Graettinger-Terril Comm School District",1,157,0.64,0,72,0,1,85,1.18,2020
"1382",2673,"Nodaway Valley Comm School District",2,300,0.67,1,159,0.63,1,141,0.71,2020
"1383",2682,"GMG Comm School District",2,225,0.89,0,121,0,2,104,1.92,2020
"1384",2709,"Grinnell-Newburg Comm School District",22,732,3.01,8,347,2.31,14,385,3.64,2020
"1385",2718,"Griswold Comm School District",3,204,1.47,0,111,0,3,93,3.23,2020
"1386",2727,"Grundy Center Comm School District",3,338,0.89,1,166,0.6,2,172,1.16,2020
"1387",2754,"Guthrie Center Comm School District",10,228,4.39,1,100,1,9,128,7.03,2020
"1388",2763,"Clayton Ridge Comm School District",24,747,3.21,13,414,3.14,11,333,3.3,2020
"1389",2766,"H-L-V Comm School District",3,150,2,1,67,1.49,2,83,2.41,2020
"1390",2772,"Hamburg Comm School District",0,21,0,0,0,0,0,13,0,2020
"1391",2781,"Hampton-Dumont Comm School District",12,657,1.83,6,286,2.1,6,371,1.62,2020
"1392",2826,"Harlan Comm School District",8,732,1.09,0,352,0,8,380,2.11,2020
"1393",2846,"Harris-Lake Park Comm School District",6,156,3.85,3,70,4.29,3,86,3.49,2020
"1394",2862,"Hartley-Melvin-Sanborn Comm School District",3,281,1.07,1,137,0.73,2,144,1.39,2020
"1395",2977,"Highland  Comm School District",5,261,1.92,2,123,1.63,3,138,2.17,2020
"1396",2988,"Hinton Comm School District",0,347,0,0,164,0,0,183,0,2020
"1397",3029,"Howard-Winneshiek Comm School District",7,588,1.19,1,266,0.38,6,322,1.86,2020
"1398",3033,"Hubbard-Radcliffe Comm School District",0,145,0,0,66,0,0,79,0,2020
"1399",3042,"Hudson Comm School District",1,359,0.28,1,178,0.56,0,181,0,2020
"1400",3060,"Humboldt Comm School District",18,746,2.41,6,357,1.68,12,389,3.08,2020
"1401",3105,"Independence Comm School District",16,683,2.34,3,332,0.9,13,351,3.7,2020
"1402",3114,"Indianola Comm School District",15,1704,0.88,7,872,0.8,8,832,0.96,2020
"1403",3119,"Interstate 35 Comm School District",2,397,0.5,0,185,0,2,212,0.94,2020
"1404",3141,"Iowa City Comm School District",127,6527,1.95,64,3243,1.97,63,3284,1.92,2020
"1405",3150,"Iowa Falls Comm School District",5,600,0.83,3,299,1,2,301,0.66,2020
"1406",3154,"Iowa Valley Comm School District",0,247,0,0,128,0,0,119,0,2020
"1407",3168,"IKM-Manning Comm School District",3,292,1.03,1,139,0.72,2,153,1.31,2020
"1408",3186,"Janesville Consolidated School District",3,161,1.86,2,82,2.44,1,79,1.27,2020
"1409",3195,"Greene County Comm School District",4,543,0.74,2,255,0.78,2,288,0.69,2020
"1410",3204,"Jesup Comm School District",2,438,0.46,0,219,0,2,219,0.91,2020
"1411",3231,"Johnston Comm School District",12,3369,0.36,3,1580,0.19,9,1789,0.5,2020
"1412",3312,"Keokuk Comm School District",19,856,2.22,7,408,1.72,12,448,2.68,2020
"1413",3330,"Keota Comm School District",2,132,1.52,1,52,1.92,1,80,1.25,2020
"1414",3348,"Kingsley-Pierson Comm School District",2,205,0.98,1,111,0.9,1,94,1.06,2020
"1415",3375,"Knoxville Comm School District",12,764,1.57,7,379,1.85,5,385,1.3,2020
"1416",3420,"Lake Mills Comm School District",5,323,1.55,2,163,1.23,2,159,1.26,2020
"1417",3465,"Lamoni Comm School District",2,148,1.35,2,70,2.86,0,78,0,2020
"1418",3555,"Lawton-Bronson Comm School District",2,304,0.66,1,140,0.71,1,164,0.61,2020
"1419",3600,"Le Mars Comm School District",18,1038,1.73,8,492,1.63,10,546,1.83,2020
"1420",3609,"Lenox Comm School District",3,221,1.36,1,106,0.94,2,115,1.74,2020
"1421",3645,"Lewis Central Comm School District",15,1387,1.08,7,680,1.03,8,707,1.13,2020
"1422",3691,"North Cedar Comm School District",1,294,0.34,0,136,0,1,158,0.63,2020
"1423",3715,"Linn-Mar Comm School District",34,3389,1,15,1657,0.91,19,1732,1.1,2020
"1424",3744,"Lisbon Comm School District",4,290,1.38,1,130,0.77,3,160,1.88,2020
"1425",3798,"Logan-Magnolia Comm School District",1,293,0.34,1,148,0.68,0,145,0,2020
"1426",3816,"Lone Tree Comm School District",3,224,1.34,2,107,1.87,1,117,0.85,2020
"1427",3841,"Louisa-Muscatine Comm School District",10,388,2.58,6,191,3.14,4,197,2.03,2020
"1428",3906,"Lynnville-Sully Comm School District",1,241,0.41,0,108,0,1,133,0.75,2020
"1429",3942,"Madrid Comm School District",3,309,0.97,0,142,0,3,167,1.8,2020
"1430",3978,"East Mills Comm School District",1,222,0.45,0,107,0,1,115,0.87,2020
"1431",4023,"Manson Northwest Webster Comm School District",9,353,2.55,2,168,1.19,7,185,3.78,2020
"1432",4033,"Maple Valley-Anthon Oto Comm School District",3,357,0.84,2,168,1.19,1,189,0.53,2020
"1433",4041,"Maquoketa Comm School District",16,761,2.1,5,372,1.34,11,389,2.83,2020
"1434",4043,"Maquoketa Valley Comm School District",1,296,0.34,1,158,0.63,0,138,0,2020
"1435",4068,"Marcus-Meriden-Cleghorn Comm School District",0,174,0,0,95,0,0,79,0,2020
"1436",4086,"Marion Independent School District",9,1044,0.86,1,514,0.19,8,530,1.51,2020
"1437",4104,"Marshalltown Comm School District",88,2358,3.73,31,1137,2.73,57,1221,4.67,2020
"1438",4122,"Martensdale-St Marys Comm School District",6,252,2.38,1,112,0.89,5,140,3.57,2020
"1439",4131,"Mason City Comm School District",57,1636,3.48,27,789,3.42,30,847,3.54,2020
"1440",4149,"MOC-Floyd Valley Comm School District",9,681,1.32,2,338,0.59,7,343,2.04,2020
"1441",4203,"Mediapolis Comm School District",2,403,0.5,1,181,0.55,1,222,0.45,2020
"1442",4212,"Melcher-Dallas Comm School District",1,168,0.6,0,86,0,1,82,1.22,2020
"1443",4269,"Midland Comm School District",0,246,0,0,123,0,0,123,0,2020
"1444",4271,"Mid-Prairie Comm School District",13,608,2.14,3,297,1.01,10,311,3.22,2020
"1445",4356,"Missouri Valley Comm School District",4,363,1.1,1,173,0.58,3,190,1.58,2020
"1446",4419,"MFL MarMac Comm School District",2,359,0.56,1,159,0.63,1,200,0.5,2020
"1447",4437,"Montezuma Comm School District",1,221,0.45,1,123,0.81,0,98,0,2020
"1448",4446,"Monticello Comm School District",5,543,0.92,1,263,0.38,4,280,1.43,2020
"1449",4491,"Moravia Comm School District",1,194,0.52,1,88,1.14,0,106,0,2020
"1450",4505,"Mormon Trail Comm School District",1,90,1.11,0,48,0,1,42,2.38,2020
"1451",4518,"Moulton-Udell Comm School District",0,86,0,0,41,0,0,45,0,2020
"1452",4527,"Mount Ayr Comm School District",3,284,1.06,3,146,2.05,0,138,0,2020
"1453",4536,"Mount Pleasant Comm School District",14,880,1.59,4,444,0.9,10,436,2.29,2020
"1454",4554,"Mount Vernon Comm School District",4,658,0.61,2,336,0.6,2,322,0.62,2020
"1455",4572,"Murray Comm School District",0,125,0,0,59,0,0,66,0,2020
"1456",4581,"Muscatine Comm School District",89,2223,4,31,1141,2.72,58,1082,5.36,2020
"1457",4599,"Nashua-Plainfield Comm School District",2,279,0.72,0,132,0,2,147,1.36,2020
"1458",4617,"Nevada Comm School District",1,714,0.14,0,342,0,1,372,0.27,2020
"1459",4644,"Newell-Fonda Comm School District",4,247,1.62,2,126,1.59,2,121,1.65,2020
"1460",4662,"New Hampton Comm School District",8,488,1.64,5,249,2.01,3,239,1.26,2020
"1461",4689,"New London Comm School District",6,250,2.4,6,116,5.17,0,134,0,2020
"1462",4725,"Newton Comm School District",50,1371,3.65,24,690,3.48,26,681,3.82,2020
"1463",4772,"Central Springs Comm School District",4,335,1.19,1,159,0.63,3,176,1.7,2020
"1464",4773,"Northeast Comm School District",1,424,0.24,1,224,0.45,0,200,0,2020
"1465",4774,"North Fayette Valley Comm School District",6,474,1.27,3,217,1.38,3,257,1.17,2020
"1466",4776,"North Mahaska Comm School District",2,264,0.76,1,127,0.79,1,137,0.73,2020
"1467",4777,"North Linn Comm School District",3,278,1.08,1,140,0.71,2,138,1.45,2020
"1468",4778,"North Kossuth Comm School District",0,99,0,0,49,0,0,50,0,2020
"1469",4779,"North Polk Comm School District",1,863,0.12,1,422,0.24,0,441,0,2020
"1470",4784,"North Scott Comm School District",15,1492,1.01,6,733,0.82,9,759,1.19,2020
"1471",4785,"North Tama County Comm School District",3,214,1.4,0,95,0,3,119,2.52,2020
"1472",4788,"Northwood-Kensett Comm School District",2,240,0.83,0,104,0,2,136,1.47,2020
"1473",4797,"Norwalk Comm School District",3,1480,0.2,1,710,0.14,2,770,0.26,2020
"1474",4860,"Odebolt Arthur Battle Creek Ida Grove Comm School District",8,466,1.72,3,217,1.38,5,249,2.01,2020
"1475",4869,"Oelwein Comm School District",16,575,2.78,7,268,2.61,9,307,2.93,2020
"1476",4878,"Ogden Comm School District",2,334,0.6,2,145,1.38,0,189,0,2020
"1477",4890,"Okoboji Comm School District",10,522,1.92,5,260,1.92,5,262,1.91,2020
"1478",4978,"Orient-Macksburg Comm School District",1,74,1.35,0,36,0,1,38,2.63,2020
"1479",4995,"Osage Comm School District",0,441,0,0,214,0,0,227,0,2020
"1480",5013,"Oskaloosa Comm School District",17,939,1.81,8,431,1.86,9,508,1.77,2020
"1481",5049,"Ottumwa Comm School District",44,2023,2.17,13,984,1.32,31,1039,2.98,2020
"1482",5121,"Panorama Comm School District",8,361,2.22,3,179,1.68,5,182,2.75,2020
"1483",5139,"Paton-Churdan Comm School District",0,97,0,0,50,0,0,47,0,2020
"1484",5160,"PCM Comm School District",2,513,0.39,0,226,0,2,287,0.7,2020
"1485",5163,"Pekin Comm School District",3,326,0.92,3,161,1.86,0,165,0,2020
"1486",5166,"Pella Comm School District",4,1083,0.37,0,510,0,4,573,0.7,2020
"1487",5184,"Perry Comm School District",17,821,2.07,7,379,1.85,10,442,2.26,2020
"1488",5250,"Pleasant Valley Comm School District",10,2369,0.42,6,1167,0.51,4,1202,0.33,2020
"1489",5256,"Pleasantville Comm School District",1,330,0.3,0,147,0,1,183,0.55,2020
"1490",5283,"Pocahontas Area Comm School District",11,414,2.66,2,204,0.98,9,210,4.29,2020
"1491",5310,"Postville Comm School District",4,352,1.14,2,171,1.17,2,181,1.1,2020
"1492",5325,"Prairie Valley Comm School District",0,313,0,0,135,0,0,178,0,2020
"1493",5463,"Red Oak Comm School District",14,481,2.91,4,244,1.64,10,237,4.22,2020
"1494",5486,"Remsen-Union Comm School District",0,98,0,0,44,0,0,54,0,2020
"1495",5508,"Riceville Comm School District",0,155,0,0,74,0,0,81,0,2020
"1496",5510,"Riverside Comm School District",4,260,1.54,0,116,0,4,144,2.78,2020
"1497",5607,"Rock Valley Comm School District",1,403,0.25,0,190,0,1,213,0.47,2020
"1498",5643,"Roland-Story Comm School District",5,491,1.02,2,232,0.86,3,259,1.16,2020
"1499",5697,"Rudd-Rockford-Marble Rk Comm School District",1,210,0.48,0,97,0,1,113,0.88,2020
"1500",5724,"Ruthven-Ayrshire Comm School District",1,84,1.19,0,47,0,1,37,2.7,2020
"1501",5751,"St Ansgar Comm School District",1,261,0.38,1,137,0.73,0,124,0,2020
"1502",5805,"Saydel Comm School District",9,639,1.41,3,303,0.99,6,336,1.79,2020
"1503",5823,"Schaller-Crestland Comm School District",0,129,0,0,49,0,0,80,0,2020
"1504",5832,"Schleswig Comm School District",0,45,0,0,20,0,0,25,0,2020
"1505",5877,"Sergeant Bluff-Luton Comm School District",2,776,0.26,0,376,0,2,400,0.5,2020
"1506",5895,"Seymour Comm School District",0,115,0,0,58,0,0,57,0,2020
"1507",5922,"West Fork Comm School District",5,299,1.67,2,139,1.44,3,160,1.88,2020
"1508",5949,"Sheldon Comm School District",12,531,2.26,5,251,1.99,7,280,2.5,2020
"1509",5976,"Shenandoah Comm School District",7,470,1.49,3,211,1.42,4,259,1.54,2020
"1510",5994,"Sibley-Ocheyedan Comm School District",9,374,2.41,3,182,1.65,6,192,3.13,2020
"1511",6003,"Sidney Comm School District",3,242,1.24,0,112,0,3,130,2.31,2020
"1512",6012,"Sigourney Comm School District",1,256,0.39,1,130,0.77,0,126,0,2020
"1513",6030,"Sioux Center Comm School District",25,649,3.85,9,324,2.78,16,325,4.92,2020
"1514",6035,"Sioux Central Comm School District",11,389,2.83,0,161,0,11,228,4.82,2020
"1515",6039,"Sioux City Comm School District",111,6644,1.67,47,3256,1.44,64,3388,1.89,2020
"1516",6091,"South Central Calhoun Comm School District",2,360,0.56,1,181,0.55,1,179,0.56,2020
"1517",6093,"Solon Comm School District",2,736,0.27,1,358,0.28,1,378,0.26,2020
"1518",6094,"Southeast Warren Comm School District",6,243,2.47,2,113,1.77,4,130,3.08,2020
"1519",6095,"South Hamilton Comm School District",6,340,1.76,1,170,0.59,5,170,2.94,2020
"1520",6096,"Southeast Webster Grand Comm School District",0,167,0,0,84,0,0,83,0,2020
"1521",6097,"South Page Comm School District",1,60,1.67,0,26,0,1,34,2.94,2020
"1522",6098,"South Tama County",19,709,2.68,7,326,2.15,12,383,3.13,2020
"1523",6099,"South O'Brien  Comm School District",5,274,1.82,2,121,1.65,3,153,1.96,2020
"1524",6100,"South Winneshiek Comm School District",0,261,0,0,109,0,0,152,0,2020
"1525",6101,"Southeast Polk Comm School District",44,3331,1.32,19,1630,1.17,25,1701,1.47,2020
"1526",6102,"Spencer Comm School District",14,1062,1.32,8,526,1.52,6,536,1.12,2020
"1527",6120,"Spirit Lake Comm School District",4,564,0.71,2,278,0.72,2,286,0.7,2020
"1528",6138,"Springville Comm School District",4,195,2.05,3,94,3.19,1,101,0.99,2020
"1529",6165,"Stanton Comm School District",0,110,0,0,52,0,0,58,0,2020
"1530",6175,"Starmont Comm School District",1,278,0.36,0,141,0,1,137,0.73,2020
"1531",6219,"Storm Lake Comm School District",48,1221,3.93,18,592,3.04,30,629,4.77,2020
"1532",6264,"West Central Valley Comm School District",7,387,1.81,2,186,1.08,5,201,2.49,2020
"1533",6273,"Sumner-Fredericksburg Comm School District",1,388,0.26,0,210,0,1,178,0.56,2020
"1534",6408,"Tipton Comm School District",7,486,1.44,4,248,1.61,3,238,1.26,2020
"1535",6453,"Treynor Comm School District",1,389,0.26,1,198,0.51,0,191,0,2020
"1536",6460,"Tri-Center Comm School District",2,316,0.63,0,156,0,2,160,1.25,2020
"1537",6462,"Tri-County Comm School District",2,110,1.82,1,58,1.72,1,52,1.92,2020
"1538",6471,"Tripoli Comm School District",2,184,1.09,1,95,1.05,1,89,1.12,2020
"1539",6509,"Turkey Valley Comm School District",1,176,0.57,0,87,0,1,89,1.12,2020
"1540",6512,"Twin Cedars Comm School District",5,149,3.36,1,60,1.67,4,89,4.49,2020
"1541",6534,"Underwood Comm School District",1,373,0.27,1,169,0.59,0,204,0,2020
"1542",6536,"Union Comm School District",3,471,0.64,1,214,0.47,2,257,0.78,2020
"1543",6579,"Urbandale Comm School District",4,1952,0.2,1,936,0.11,3,1016,0.3,2020
"1544",6592,"Van Buren County Comm School District",9,354,2.54,4,162,2.47,5,192,2.6,2020
"1545",6615,"Van Meter Comm School District",2,393,0.51,1,177,0.56,1,216,0.46,2020
"1546",6651,"Villisca Comm School District",0,114,0,0,61,0,0,53,0,2020
"1547",6660,"Vinton-Shellsburg Comm School District",19,653,2.91,10,349,2.87,9,304,2.96,2020
"1548",6700,"Waco Comm School District",3,212,1.42,0,95,0,3,117,2.56,2020
"1549",6741,"East Sac County Comm School District",4,370,1.08,3,191,1.57,1,179,0.56,2020
"1550",6759,"Wapello Comm School District",5,289,1.73,3,134,2.24,2,155,1.29,2020
"1551",6762,"Wapsie Valley Comm School District",0,318,0,0,146,0,0,172,0,2020
"1552",6768,"Washington Comm School District",23,736,3.13,10,354,2.82,13,382,3.4,2020
"1553",6795,"Waterloo Comm School District",127,4763,2.67,57,2369,2.41,70,2394,2.92,2020
"1554",6822,"Waukee Comm School District",10,4943,0.2,6,2435,0.25,4,2508,0.16,2020
"1555",6840,"Waverly-Shell Rock Comm School District",13,1145,1.14,6,525,1.14,7,620,1.13,2020
"1556",6854,"Wayne Comm School District",1,254,0.39,1,129,0.78,0,125,0,2020
"1557",6867,"Webster City Comm School District",27,866,3.12,9,403,2.23,18,463,3.89,2020
"1558",6921,"West Bend-Mallard Comm School District",3,172,1.74,1,86,1.16,2,86,2.33,2020
"1559",6930,"West Branch Comm School District",2,361,0.55,0,166,0,2,195,1.03,2020
"1560",6937,"West Burlington Ind School District",19,461,4.12,7,240,2.92,12,221,5.43,2020
"1561",6943,"West Central Comm School District",0,121,0,0,64,0,0,57,0,2020
"1562",6950,"West Delaware County Comm School District",9,729,1.23,3,356,0.84,6,373,1.61,2020
"1563",6957,"West Des Moines Comm School District",60,4247,1.41,19,2043,0.93,41,2204,1.86,2020
"1564",6961,"Western Dubuque Comm School District",8,1651,0.48,2,800,0.25,6,851,0.71,2020
"1565",6969,"West Harrison Comm School District",2,139,1.44,0,64,0,2,75,2.67,2020
"1566",6975,"West Liberty Comm School District",8,550,1.45,3,262,1.15,5,288,1.74,2020
"1567",6983,"West Lyon Comm School District",1,445,0.22,1,208,0.48,0,237,0,2020
"1568",6985,"West Marshall Comm School District",3,478,0.63,0,250,0,3,228,1.32,2020
"1569",6987,"West Monona Comm School District",7,302,2.32,3,153,1.96,4,149,2.68,2020
"1570",6990,"West Sioux Comm School District",3,386,0.78,2,188,1.06,1,198,0.51,2020
"1571",6992,"Westwood Comm School District",0,283,0,0,141,0,0,142,0,2020
"1572",7002,"Whiting Comm School District",2,86,2.33,2,44,4.55,0,42,0,2020
"1573",7029,"Williamsburg Comm School District",0,582,0,0,294,0,0,288,0,2020
"1574",7038,"Wilton Comm School District",5,401,1.25,3,186,1.61,2,215,0.93,2020
"1575",7047,"Winfield-Mt Union Comm School District",3,204,1.47,2,97,2.06,1,107,0.93,2020
"1576",7056,"Winterset Comm School District",2,809,0.25,2,382,0.52,0,427,0,2020
"1577",7092,"Woodbine Comm School District",1,203,0.49,1,82,1.22,0,121,0,2020
"1578",7098,"Woodbury Central Comm School District",2,286,0.7,1,148,0.68,1,138,0.72,2020
"1579",7110,"Woodward-Granger Comm School District",3,385,0.78,2,187,1.07,1,198,0.51,2020
